தமிழ்	t̪ɐmiɻ
இந்தியா	in̪t̪ijaː
மும்பை	mumpɐi̯
நன்றி	n̪ɐnti
வணக்கம்	ʋɐɳɐkkɐm
ஆமாம்	aːmaːm
ஃபேஸ்புக்	feːspuk
புரியவில்லை	purijɐʋillɐi̯
கால	kaːlɐ
வணக்க	ʋɐɳɐkkɐ
மதிய	mɐt̪ijɐ
நல்வாழ்த்துக்க	n̪ɐlʋaːɻt̪t̪ukkɐ
என	enɐ
பண	pɐɳɐ
அறிஞர்கள்	ɐriɲɐrkɐɭ
இங்ஙன்னா	iŋŋɐnnaː
பயணம்	pɐjɐɳɐm
திரும்ப	t̪irumpɐ
தத்தம்	t̪ɐt̪t̪ɐm
ஸ்ரீ	ʃriː
