abavumelekileyo	a b_< a v u m E l E k_> i l E j O
angekhoyo	a N g E k_h O j O
engxoxo	E N |\|\g_0 O |\|\ O
esandla	E s a n K\ a
esibhekiselele	E s i b_h E k_> i s E l E l E
ezaa	E z a
ezigqithileyo	E z i !\g_0 i t_h i l E j O
imigruzuko	i m i G u z u k_> O
intshukumo	i n tS_> u k_> u m O
isinhanha	i s i n_h a n_h a
ixhoba	i |\|\h O b_< a
izityholo	i z i c_h O l O
kratya	kx_> a c_> a
kuqhubela	k_> u !\h u b_< E l a
kwakuvunyelwa	k_> w a k_> u v u J E l w a
kweeyure	k_> w E j u r E
kwentlalo	k_> w E n tK_> a l O
kwiimfuneko	k_> w i m f u n E k_> O
namashumi	n a m a S u m i
nangokuthembeka	n a N g O k_> u t_h E m b_< E k_> a
neenkcukacha	n E n |\ u k_> a |\h a
nezoomasipala	n E z O m a s i p_> a l a
ngokommiselo	N g O k_> O m i s E l O
ngokukhalipha	N g O k_> u k_h a l i p_h a
ngokwenkqubo	N g O k_> w E n !\ u b_< O
nobuhlanga	n O b_< u K a N g a
nolutsha	n O l u tS_h a
olugcinwe	O l u |\g_0 i n w E
olusebenzayo	O l u s E b_< E n z a j O
omhlaba	O m K a b_< a
shedyuli	S E J\ u l i
ufunde	u f u n d E
ujongana	u d_0Z O N g a n a
umhambi	u m_h a m b_< i
umnyhadala	u m J_h a d a l a
zorhwebo	z O r w E b_< O
zotywala	z O c_> w a l a
