# Pronunciation rules for isiXhosa.
#
# Author: mjansche@google.com (Martin Jansche)

::Lower;

ntsh → nt͡ʃʼ;

nyh → ɲʰ;
tsh → t͡ʃʰ;
tyh → cʰ;

bh → bʰ;
ch → ǀʰ;
dl → ɮ;
dy → ɟ;
gc → ɡ͡ǀ;
gq → ɡ͡ǃ;
gr → ɣ;
gx → ɡ͡ǁ;
hl → ɬ;
kh → kʰ;
kr → k͡x;
mh } [^l] → mʰ;
nh → nʰ;
ny → ɲ;
ph → pʰ;
qh → ǃʰ;
sh → ʃ;
th → tʰ;
tl → t͡ɬʼ;
ts → t͡sʼ;
ty → cʼ;
xh → ǁʰ;

aa → | a;
ee → | e;
ii → | i;
kc → | c;
kq → | q;
mm → | m;
oo → | o;
uu → | u;

a → a;
b → ɓ;
c → ǀ;
d → d;
e → ɛ;
f → f;
g → ɡ;
r { h → ;
h → h;
i → i;
j → d͡ʒ;
k → kʼ;
l → l;
m → m;
n } g → ŋ;
n → n;
o → ɔ;
p → pʼ;
q → ǃ;
r → r;
s → s;
t → tʼ;
u → u;
v → v;
w → w;
x → ǁ;
y → j;
z → z;
