O	ɔ
a	a
i	i
u	u
e	e
E	æ
o	o
i^	i̯
u^	u̯
e^	e̯
o^	o̯
k	k
kh	kʰ
g	ɡ
gh	ɡʰ
N	ŋ
c	c
ch	cʰ
j	ɟ
jh	ɟʰ
T	ʈ
Th	ʈʰ
D	ɖ
Dh	ɖʰ
t	t
th	tʰ
d	d
dh	dʰ
n	n
p	p
f	f
b	b
bh	bʰ
m	m
r	r
l	l
sh	ʃ
s	s
h	h
