by	b a y
cry	k r a y
dry	d r a y
fly	f l a y
fry	f r a y
gym	j i m
hymns	h i m z
lymph	l i m f
my	m a y
myth	m i t
myths	m i t s
pwn	p o n
rhythm	r i t ex m
rmv	a r e m f i
shy	sy a y
shyly	sy a y l i
sky	s k a y
sly	s l a y
spy	s p a y
try	t r a y
why	w a y
yr	w a y a r
