অভিধান	ôbhidhan
ডিকশনারী	ḍikshônari
ডিকশনারি	ḍikshônari
বিশ্বকোষ	bishbakosh
বেড়াল	beṛāl
বিলাড়	bilāṛ
শব্দ	shôbdô
বই	bôi
গ্রন্থ	grônthô
পুস্তক	pustôk
হাতি	hati
বাদামি	badami
ডিসেম্বর	Ḑisembôr
জানুয়ারি	jānuẏāri
এপ্রিল	ēpril
সেপ্টেম্বর	Sepţembôr
অক্টোবর	Ôkţobôr
দিন	din
সোমবার	shombar
মঙ্গলবার	monggolbar
বুধবার	budhbar
বৃহস্পতিবার	brihôshpôtibar
শুক্রবার	shukrôbar
শনিবার	shônibar
রবিবার	rôbibar
প্রতিশব্দ	prôtishôbdô
বিশেষ্য	bisheshya
ঘন্টা	ghônţa
মিনিট	miniṭ
বাণিজ্য	baniyô
ক্রিয়া	kriya
বিশেষণ	bisheshawn
ঈগল	igôl
ইগল	igôl
মাথা	matha
কুমড়া	kumôŗa
নাম	nam
ওযু	oyu
শীতকাল	shitôkal
শীত	shit
হাড়	haŗ
হাড়	haŗ
যন্ত্রমানব	Yantramānaba
ইংরেজি	ingreji
ইংরেজি	inrējī
ইংরেজি	inreji
ইংরেজি ভাষা	inreji bhasha
ইংরেজি ভাষা	inrēji bhāṣā
আজ	aj
-টা	-ţa
-টি	-ţi
-গুলা	-gula
-গুলো	-gulo
-রা	-ra
-এরা	-era
ঋতু	ritu
শরৎ	shôrôt
হেমন্ত	hemôntô
গ্রীষ্ম	grisshô
বসন্ত	bôshônto
রং	rông
ভিতর	bhitara
গুগল করছি	gūgal korchi
কমলা	kômla
কমলা	kômla
সাত	sat
নেকড়ে	nekŗe
গ্রহ	grôh
গ্রহ	grôh
তারকা	tarka
তারা	tara
আকাশ	akash
শূন্য	śūnya
সংখ্যা	sônkhya
নম্বর	nômbôr
নম্বর	nômbôr
বর্ণমালা	barṇamālā
অম্ল	ôml
জার্মান ভাষা	jārmān bhāṣā
মেক্সিকো	meksiko
ঘাস	ghas
এক	ek
দুই	dui
তিন	tin
চার	car
পাঁচ	pãc
কেজিবি	kejibi
অক্ষর	ôkshôr
চিঠি	ciţhi
দ্বিতীয়	dbitīyô
সেকেন্ড	sekenḑ
শতাব্দী	shôtabdi
ঘড়ি	ghôŗi
জাপান	japan
কম	kôm
আমি তোমাকে ভালবাসি	ami tomake bhalôbashi
আই তরে ভালাবাষি	Aai tore balabashi
বিয়ার	biẏar
ছাতা	chata
বিন্দু	bindu
সূর্য	surjô
সূর্য	surjô
মানুষ	manush
মানব	manôb
আদমি	ādami
হওয়া	hôoẇa
ধন	dhôn
মাদারচোদ	madarchod
পাদা	pada
ধর্ষণ	dhôrôshôn
মাল	mal
মাল ফেলা	mal phela
পোর্ট	porţ
ছয়	chay
খেজুর	khejur
তারিখ	tarikh
নাসা	nāsā
ভাষা	bhasha
ভাষা	bhāṣā
ক্রিয়া-বিশেষণ	kriya-bisheshan
কারণ	karôn
রেলপথ	relpôth
বিলিয়ন	biliẏôn
আট	aţ
নয়	noy
দশ	daś
হাগু	hagu
সবাই	shôbai
বাদক	bādak
জাহান্নাম	jahannam
পেনসিল	pensil
নেদারল্যান্ডস	nedarlyanḑôs
হল্যান্	hôlyanḑ
সোভিয়েত ইউনিয়ন	sobhiyet i'uniyôn
সঙ্গীত	sônggit
যুদ্ধ	yuddhô
শান্তি	śānti
ষান্তি	śānti
শান্তি	šānti
এবং	ebông
আর	ar
দেশ	desh
রাষ্ট্র	rashţrô
বেলজিয়াম	beljiẏam
গ্রিস	gris
গ্রীস	gris
যুক্তরাজ্য	Juktôrajjô
মার্কিন যুক্তরাষ্ট্র	markin juktôrashţrô
জার্মানি	jarmani
চেক প্রজাতন্ত্র	cek prôjatôntrô
ফ্রান্স	phrans
নিউজিল্যান্ড	ni'ujilyanḑ
ইসরায়েল	israyel
ইস্তোনিয়া	istoniẏa
লিথুয়ানিয়া	lituyaniya
নরওয়ে	Nar'ōẏē
সুইডেন	su'iḑen
ফিনল্যান্ড	phinlænḑ
মরোক্কো	môrokko
তিউনিসিয়া	ti'unisiẏa
মিশর	mishôr
মিসর	misôr
দক্ষিণ আফ্রিকা	dôkhin aphrika
পোল্যান্ড	Polyanḑ
অস্ট্রিয়া	osṭriẏā
আইসল্যান্ড	aislyanḑô
মালয়েশিয়া	mālaẏēśiẏā
ফিলিপাইন	philipa'in
গ্রিনল্যান্ড	grinlænḑ
বেতন	betôn
এখন	êkhôn
ব্যাংক	bêngk
কর	kôr
আেপল	apel
আপেল	apel
অর্থনীতি	ôrthôniti
খোলা	khola
ফল	phal
স্তন্যপায়ী	stôn'yôpaẏi
স্বামী	sbami
পতি	pôti
ধর্ম	dhôrmô
সরকার	shôrkar
সর্কার	shôrkar
বড়	bôŗô
দেওয়াল	deoyal
দেওয়াল	deoyal
পাঠা	paṭha
বাজার	bajar
মার্কেট	markeţ
খাদ্য	khadyô
বিশ্ব	biśba
দুনিয়া	duniya
জগত	jôgôt
দুনিয়া	duniya
গ্রহণ করা	grôhan kôra
নেওয়া	neoẇa
নেওয়া	neoa
কিন্তু	kintu
গতকাল	gôtôkal
কম্পনী	kōmpāni
-ও	-o
নেটওয়ার্ক	neţoẇark
মোবাইল ফোন	moba'il phon
কাজ	kaj
কাজ করা	kaj kôra
প্রথম	prôthôm
রেডিও	reḑio
সতর্ক	sôtôrkô
সাবধান	sābdhān
সময়	shômôẏ
তুই	tui
আফগানিস্তান	aphganistan
আর্মেনিয়া	armeniẏa
আর্জেন্টিনা	arjenţina
আজারবাইজান	ajarba'ijan
বাংলাদেশ	bangladesh
বুলগেরিয়া	bulgeriya
বলিভিয়া	bôlibhiya
ব্রাজিল	brajil
বাহামা	Bāhāmā
ভুটান	bhuţan
বতসোয়ানা	batsōẏānā
কানাডা	kanaḑa
সুইজারল্যান্ড	su'ijārlyānḍ
চিলি	cili
চীন	cin
গণচীন	gôncin
কলম্বিয়া	kôlômbiẏa
কলোমবিয়া	kôlombiẏa
কিউবা	Ki'uba
ডেনমার্ক	ḑenmark
ডোমিনিকান প্রজাতন্ত্র	ḍōminikāna prajātantra
ইকুয়েডর	ikuyeḑôr
স্পেন	spen
ইথিওপিয়া	ithi'ōpiẏā
রক্ত	rôktô
এইডস	eiḑs
অসুখ	ôsukh
রোগ	rog
ঘানা	Ghana
গায়ানা	gayana
হন্ডুরাস	hanḍurās
হাইতি	hā'iti
হাঙ্গেরি	hangeri
ইন্দোনেশিয়া	indōnēśiẏā
ভারত	bharôt
ইরান	iran
ইতালি	itali
জামাইকা	jāmā'ikā
কেনিয়া	kēniẏā
কম্বোডিয়া	kômboḑiya
আশু	ashu
স্বাগতম	sbagôtôm
নতুন	nôtun
নতুন	nôtun
নতুন	nôtun
নতুন	nôtun
নতুন	nôtun
গ্যাস	gæs
লাওস	la'os
লিশ্টেনশ্টাইন	lishţenshţa'in
লুক্সেমবুর্গ	luksemburg
মোনাকো	monako
মঙ্গোলিয়া	môṅgoliẏa
মাল্টা	malṭa
মোজাম্বিক	mojambik
নামিবিয়া	nāmibiẏā
নাইজার	nāijār
নাইজেরিয়া	nāijēriẏā
অনুবাদ	ônubad
তর্জমা	tôrjôma
অনুবাদ	ônubad
প্রেম	prem
ভালোবাসা	bhalobasa
ভালবাসা	bhalôbasha
ফরাসি ভাষা	pharāsi bhāṣā
নেপাল	nepal
পেরু	peru
পাকিস্তান	pakistan
পর্তুগাল	pôrtugal
প্যারাগুয়ে	pæraguye
কাতার	katar
রোমানিয়া	romaniya
সুদান	sudan
স্লোভেনিয়া	slobheniya
এল সালভাদোর	el salbhador
সিরিয়া	siria
শ্যামদেশ	shyamdesh
ইউক্রেন	yukren
উগান্ডা	ugānḍā
যুক্তরাষ্ট্র	juktôrashţrô
উরুগুয়ে	uruguye
ভেনেজুয়েলা	bhenejuẏela
ভিয়েতনাম	bhiẏetnam
ইয়েমেন	iẏemen
জাম্বিয়া	jāmbiẏā
আধুনিক	adhunik
সফটওয়্যার	sôphţowar
কম্পিউটার	kômpiuţar
গণকযন্ত্র	gaṇakyantra
স্পেনীয় ভাষা	spēnīẏ bhāṣā
অস্ট্রেলিয়া	ôsţreliya
বসনিয়া ও হার্জেগোভিনা	bôsniya o harjegobhina
ব্রুনাই	bruna'i
ব্রুনেই	brune'i
বেলারুশ	belarush
উজবেকিস্তান	ujbekistan
টুভালু	ṭubhalu
তুর্কমেনিস্তান	turkômenistan
বিষ	bish
মানচিত্র	mancitrô
পূর্ব টিমোর	purbô ţimor
তাজিকিস্তান	tajikistan
সোমালিয়া	somaliẏa
শ্রীলঙ্কা	shrilôngka
দক্ষিণ কোরিয়া	dôkhin koriẏa
উত্তর কোরিয়া	uttôr koriẏa
সৌদি আরব	saudi arôb
ঝড়	jhaṛ
সেশেল	
রাশিয়া	rashiẏa
লেসোথো	lesotho
কিরগিজিস্তান	kirgijistan
কাজাখস্তান	kajakhstan
অর্থ	arth
টাকা	ţaka
পুছা	pucha
রাত	rat
সেনা	sena
পানীয়	panīẏô
গাই	gai
গরু	gôru
কোস্টা রিকা	kosṭā rikā
ক্রোয়েশিয়া	kroyeshiya
জর্জিয়া	jorjiya
গিনি	gini
গিনি-বিসাউ	gini-bisāu
মলদোভা	Môldobha
ব্রহ্মদেশ	brôhmôdeš
মায়ানমার	maẏanmar
বার্মা	barma
বার্মা	barma
ব্রহ্মদেশ	brôhmôdesh
শিশু	shishu
জি	ji
হ্যাঁ	hêñ
হ্যাঁ	ɦæ̃
দাঁড়ানো	dãŗano
দাঁড়ানো	dãŗano
মাইক্রোনেশিয়া	ma'ikroneshiya
উচ্চারণ	uccarôn
আইসল্যান্ডিক	ā'isalyānḍika
ম্যাসেডোনিয়া	mæseḑoniya
মেসিডোনিয়া	mesiḑoniya
ম্যাসেডোনিয়া প্রজাতন্ত্র	mæseḑoniya prôjatôntr
তাইওয়ান	ta'i'oẏan
রাষ্ট্রপতি	rashţrôpti
নিরাপত্তা	nirapôtta
চোদা	coda
চোদা	coda
ধুর বাল	dhur bal
ওয়েব ব্রাউজার	oyeb bôra'ujar
বন্ধ করা	bôndhô kôra
বন্ধ করা	bôndhô kôra
হত্যা করা	hôtya kôra
বধ করা	bôdh kôra
কেনা	kena
এখানে	ekhane
এখান	ekhan
গাছ	gach
ফিনীয় ভাষা	phinīẏa bhāṣā
দেওয়া	deoẇa
কলা	kôla
বাঘ	bagh
এগারো	egaro
বারো	baro
বোমা	boma
মেহেদী	mehedi
মেহেদী	mehedi
ইংল্যান্ড	inlænḑ
গির্জা	girja
ছোট	choṭô
টমেটো	ţômeţo
সোভিয়েত সমাজতান্ত্রিক প্রজাতন্ত্রের ঐক্য	sobhiyetô sômajôtantrikô prôjatôntrerô aikyô
জাপানি ভাষা	japani bhasha
জাপানি	japani
স্লোভেনীয় ভাষা	slobheniẏa bhasha
স্লোভেনীয়	slobheniẏa
টুল	ţul
কালো	kalo
কাল	kalô
নীল	nil
সোনা	seānā
সবুজ	sabuja
ম্যাজেন্টা রঙ্	myājēnṭā raṅ
গোলাপী	gōlāpī
লাল	lāl
লোহিত	lohit
রুপা	rupa
সাদা	shada
হলদে	hôlde
চতুর্থ	côturthô
তৃতীয়	tôtiyô
পঞ্চম	pôncôm
চীনা ভাষা	Cina bhasha
ভেরী	Bhērī
বেত	bēta
ষষ্ঠ	shôshţhô
সপ্তম	shôptôm
অষ্টম	ôshţôm
নবম	nôbôm
দশম	dôshôm
ইতালীয়	বাংলা
ফুটবল	phuţbôl
যুবক	yubôk
যুবতী	jubôti
তরুণ	tôruṇ
জোয়ান	joyan
তোরা	tōrā
তোমরা	tōmrā
আপনারা	āpnārā
তুই	tu'i
তুমি	tumi
আপনি	āpni
তুমি	tumi
লেখক	lekhôk
লেখা	lekha
ক্ষত	kshôt
ঘাত	ghat
নারী	nārī
রাজা	raja
রাণী	raṇi
সসেজ	sôsej
ডলার	ḍôlar
দেখা	dêkha
মধ্যরাত	madhyarāt
ইঁদুর	ĩdur
মাউস	maus
সাড়ে	ʃaɽe
পৌনে দুইটা	poune duiṭa
রাউটার	ra'uţar
কীবোর্ড	kiborḑ
বয়স	bôyôsh
ব্যক্তি	byakti
লোক	lok
রুশ ভাষা	rushô bhasha
রুশ	rushô
রাশান	rashan
রাশিয়ান	rashiyan
রুশী	rushi
রুশি	rushi
রুশ	ruś
বা	ba
অথবা	ôthôba
কিংবা	kingba
তেরো	tero
চোদ্দ	coddô
নুযুত	nuyuta
মিলিয়ন	miliẏôn
ঘনক	ghônôk
পনেরো	pônero
সতেরো	shôtero
সোলো	sholo
উনিশ	unish
কুড়ি	kuŗi
বিশ	bish
ত্রিশ	trish
তিরিশ	tirish
চল্লিশ	côllish
পঞ্চাশ	pôncash
ষাট	shaţ
সত্তর	sôttôr
আশি	ashi
নব্বই	nôbbôi
শত	śata
একশ	ēkaś
হাজার	hajar
কম্পাস	kampāsa
আঠারো	aţharo
দাবা	daba
ব্লোজব	blojôb
ব্লো-জব	blo-jôb
হাগু	hagu
হাগা	haga
হাগা	haga
একটু	ekaţu
একটু	ekaţu
একটু	ekaţu
হাত	hat
মুদ্রা 	mudrā
জানোয়ার	janoẇar
-ও	-o
বেশী	beshi
এই	ei
এইটা	eiţa
এটা	eţa
এইটি	eiţi
এটি	eţi
এইটা	eiţa
এটা	eţa
এইটি	eiţi
এটি	eţi
ইউনিকোড	i'unikoḑ
হরিণ	hariṇ
জেবরা	zebra
ছবি	chôbi
গাছ	gach
বৃক্ষ	brikkhô
ছেলে	chele
মেয়ে	meẏe
আমার	amar
আমাদের	amader
আর্টিকেল	arţikel
অকর্মক ক্রিয়া	ôkôrmôk kriya
ভবিষ্যৎ	bhôbishyôt
খামির	khāmira
চামড়া	camŗa
আবার	abar
দ্বীপ	dip
পাখী	pākhī
মাছ	mach
বিবাদ	bibad
কুইবেক	kuibēk
বায়ু	baẏu
প্রায়	pray
কোণ	kon
উত্তর	uttôr
পিঁপড়া	pim̐paṛā
বাহু	bāhu
শিল্প	shilpô
চাঁদ	cãd
উত্তর	uttôr
পূর্ব	purbô
দক্ষিণ	dôkshin
পশ্চিম	pôshcim
কোরিয়া	koriẏa
সাপ	shap
কি	ki
পেরেন্ট	perenţ
অভিভাবক	ôbhibhabôk
আব্বা	abba
পিতা	pita
বাবা	baba
মাতা	mata
মা	ma
ভাই	bhai
ভ্রাতা	bhrata
বোন	bon
ভগিনী	bhôgini
শিশু	śiśu
চাইল্ড	cā'ilḍ
ছেলে	chele
পুত্র	putrô
মেয়ে	meye
বালিকা	balika
দাদু	dadu
নানী	nani
নাতনি	natni
মৌমাছি	maumachi
মধু	môdhu
গাড়ি	gaŗi
ডানা	ḑana
শীত	śīt
গরম	gôrôm
তাপমাত্রা	tapmatra
তাপমাত্রা	tapmatra
তাজা	taja
জোস	jos
জোস	jos
থাই ভাষা	thai vasha
থাই।	thai
থাই	thai
রংধনু	rôngdhônu
অন্যান্য	ônnênnô
ওই	oi
সেই	shei
ওইটা	oiţa
ওটা	oţa
সেইটা	sheiţa
সেটা	sheţa
ওইটি	oiţi
ওটি	oţi
সেইটি	sheiţi
সেটি	sheţi
আঙ্গুল	angul
ফুল	phul
ভাল	bhalô
ভাল	valo
অঙ্গুষ্ঠ	aṅguṣṭh
নরওয়েজীয়	nar'ōẏējīẏa
নরওয়েজীয় ভাষা	nar'ōẏējīẏa bhāṣā
পাতিহাঁস	pātihāṁs
হাঁস	hãs
সবজি	shobji
খুব	khub
রাজ্য	rajyô
হোল	hol
নভোচারী	nâbhocari
প্রজেক্ট	prôjekţ
কত	kôtô
কিভাবে	kibhabe
কীভাবে	kibhabe
আফ্রিকান্স ভাষা	aphrikans bhasha
সাপ্তাহিক	shaptahik
সাপ্তাহিক	shaptahik
সাপ্তাহিক	shaptahik
চকলেট	côkôleţ
ক্রিম	krim
ম্যাজেন্টা রঙ্	myājēnṭā raṅ
ইঁদুর	ĩdur
ধূসর	dhūsara
বায়ুমণ্ডল	baẏumônḑôl
কাছিম	kachim
ধূমকেতু	dhumketu
পায়জামা	paẏjama
আবলুস	ablus
জলপাই	jôlôpa'i
কাছিম	kachim
কলম	kôlômô
লিখনী	likhôni
চেয়ার	ceyar
আসন	asôn
কেদারা	kedara
সভাপতি	sôbhapôti
সভানেত্রী	sôbhanetri
গোলাপ	golap
শৃঙ্খল	shrinkhôl
হেলিকোপটার	helikopţar
মশা	môsha
নমস্কার	nômôshkar
সালাম	salam
সালাম	salam
অম্বর	ômbôr
শহর	shôhôr
নগর	nôgôr
স্ট্রবেরি	sṭrabēri
লেবু	lebu
পান্না	panna
পেয়ারা	peyara
ভাত	bhat
ধান	dhan
ভাত	bhat
ডিম	ḍim
ডিম	ḍim
বাদামী	bādāmī
বিশেষ	bishesh
মসজিদ	môshjid
সহ্যশক্তি	sahyaśakti
শৌচাগার	śoucāgār
পায়খানা	pāẏekhānā
টয়লেট	ţôẏôleţ
বালতি	balti
ঈশ্বর	ishbôr
দেবতা	debôta
খারাপ	kharap
বন্ধু	bôndhu
বান্ধবী	bandhôbi
প্রজাতি	prajāti
সর্বনাম	sawrbonam
মাটি	maţi
বাদুড়	baduŗ
বিছানা	bichana
শোনা	shona
শোনা	shona
কামড়ানো	kamŗano
হাসি	haasi
ভাবা	bhaba
মনে রাখা	mône rakha
গান	gan
গাওয়া	gaoya
কাঁদা	kamda
কান্দা	kanda
ক্রন্দন করা	krôndôn kôra
চোখ	cokh
নয়ন	naẏan
শ্বাস ফেলা	shbasô phela
শুরু করা	shuru kôra
আরম্ভ করা	arômbhô kôra
শব্দ	xôbdô
সর	sôr
পজিট্রন	pôjiţrôn
পড়া	pôŗa
তন্তুসদৃশ বস্তু	tantusdr̥śa bastu
আমাদের	amader
আমরা	āmrā
সে	śe
আপনি	āpni
সে	śe
আপনি	āpni
তারা	tara
দাঁত	dãt
চুল	cul
কান	kan
কর্ণ	kôrnô
নাক	nak
মুখ	mukh
মোহানা	mohana
জিহ্বা	jihba
জিভ	jibh
জিব	jib
পা	pa
ফুট	phuṭa
হাঁটু	hãţu
গলা	gôla
ঘর্	ghar
শামুক	shamuk
মুখ	mukh
পিৎজা	pija
কে	ke
অন্টারিও	anṭāriō
গন্ধ	gôndhô
প্যান্ট	pyanţ
অনুবাদ করা	ônubad kôra
তর্জমা করা	tôrjôma kôra
জম্মু ও কাশ্মীর	jammu ō kāśmīr
হিমাচল প্রদেশ	himācal pradēś
পাঞ্জাব	Panjab
চন্ডীগড়	canḍīgaṛ
উত্তরপ্রদেশ	uttarpradēś
উত্তর প্রদেশ	uttar pradēś
সিক্কিম	sikkim
পশ্চিম বঙ্গ	Pôshcim Bônggô
পশ্চিমবঙ্গ	Pôshcimbônggô
বিহার	Bihar
ঝাড়খণ্ড	jhāṛakhaṇḍ
অরুণাচল প্রদেশ	aruṇācal pradēś
নাগাল্যান্ড	nāgālyānḍ
মিণপুর	miṇapur
মণিপুর	maṇipur
মিজোরাম	mijōrām
ত্রিপুরা	tripurā
মেঘালয়	mēghālaẏa
তামিলনাড়ু	tāmilanāṛu
তামিল নাড়ু	tāmil nāṛu
মহারাষ্ট্র	mahārāṣṭra
গুজরাট	gujarāṭa
গুজরাত	gujarāta
রাজস্থান	rājasthān
ছত্তীসগঢ়	chattīsagaṛh
হজ্জ	hôjj
ক্যানবেরা	kænbera
হাঁস	hãs
এড়ি	eŗi
হারা	hara
রাস্তা	rasta
রাস্তা	rasta
রাজপথ	rajpôth
করা	kôra
লাগানো	lagano
চোদা	coda
জরায়ু	jôrayu
কুঠার	kuţhar
আরবি	arôbi
আরবি ভাষা	Arôbi bhasha
বৃষ্টি	brishţi
ক্ষুধার্ত	kshudhartô
আবহ	abôh
আবহাওয়া	abôha'oya
ধনবাদ	dhonnobad
হায়দরাবাদ	haydôrabad
নতুন দিল্লি	Nôtun Dilli
পানাজি	pānāji
গান্ধীনগর	gāndhīnagar
রাঁচি	rām̐ci
রাঁচী	rām̐cī
তিরুবনন্তপুরম	tirubanantapuram
মুম্বাই	mumbā'i
আইজল	Āijal
গ্যাংটক	gyāṇṭak
আগরতলা	Agortôla
কলকাতা	Kôlkātā
বল	bôl
আইন	a'in
দূরত্ব	durôtba
জেলিফিশ	jeliphish
স্ত্রী	stri
পত্নী	pôtni
ট্রেন	ţren
স্কটল্যান্ড	skaṭlyānḍa
ব্যথা	bætha
কণ্ঠ্য	kaṇṭhya
গেয়	gēẏa
ছায়াপথ	chayapôth
পটি	paţi
ফিতা	phita
থালা	thala
প্রধানমন্ত্রী	prôdhanmôntri
হংকং	hôṃkôṃ
হং কং	hôṃ kôṃ
বিজ্ঞান	biggan
প্রযুক্তি	prôyukti
ভূমিকম্প	bhumikômpô
তেল	tel
পেট্রোলিয়াম	peţroliẏam
ভালুক	bhaluk
মিষ্টি	miṣṭi
বাষ্প	basp
ভাপ	bhap
নাগরিক	nagrik
পরিবার	pôribar
ওখানে	okhane
সেখানে	shekhane
ওখান	okhan
সেখান	shekhan
মুসলিম	muslim
ইসলাম	islam
রশ্মি	rôshmi
ভুরু	bhuru
চোখের পাতা	coker pata
জাগা	jaga
আনা	ana
হাগা	haga
নির্বাচন করা	nirbacôn kôra
আসা	asha
কাটা	kaţa
ঘুঘু	ghughu
আগুন	agun
অগ্নি	ôgni
স্বপ্ন	shôpnô
স্বপ্ন দেখা	shôpnô dekha
মাতাল	matalô
খাওয়া	khaoẇa
বোধ করা	bodh kôra
মাছি	māchi
ওড়া	ōḍā
বাক্য	bakyô
ভাষাবিজ্ঞান	bhāṣābijñān
ভাষাবৈজ্ঞানিক	bhashaboigganik
ভুলে যাওয়া	bhule jaoa
নিথর	nithara
যাওয়া	jaoa
গো	gō
লুকানো	lukano
লুকানো	lukano
আঘাত করা	aghat kôra
ধরা	dhôra
কবুতর	kôbutôr
মহাদেশ	môhadesh
বাজ	baj
মিথ্যা	mithya
আলো	alo
ভুল	bhul
পিঠ	piţh
আগামীকাল	agamikal
আগামীকাল	agamikal
মেশিন	mēśina
ভেড়া	bheŗa
মেষ	mesh
মাঝি	majhi
বৈঠা	baitha
সঙ্গে	shôngge
মদ	mad
শার্ট	sharţ
জুতা	jutā
ইত্যাদি	ittêdi
বলা	bôla
বজ্রধ্বনি	bôjrôdhbôni
কেন	kyano
কোথায়	kothaẹ
যেখানে	yekhane
বক্ষবন্ধনী	bôkshôbôndhôni
কাঁচি	kãci
ভবন	bhôbôn
বৃত্ত	brittô
ক্যামেরা	kæmera
পনির	pônir
ঘণ্টা	ghônţa
অপরাধ	ôpôradh
পাতক	patôk
পাপ	pap
সস্তা	sôsta
চিবুক	cibuk
তখন	tôkhôn
এরপর	erpôr
তারপর	tarpôr
সহজ	sôhôj
বুদ্বুদ	budbuda
ব্যাগ	bæɡ
নৌকা	nouka
শরীর	shôrir
দেহ	deho
বোতাম	botam
রুটি	ruṭi
চক	côk
মাখন	makhôn
পুল	pul
পরদা	pôrda
সুন্দর	sundôr
ইট	iţ
দেয়া	deya
প্রমাণিত	prômanit
গণতন্ত্র	gônôtôntrô
গণতন্ত্র	gônôtôntrô
রাজনীতি	rajniti
দৌড়ান	dowŗan
করাত	kôrat
খোঁজা	khõja
বেচা	beca
গুলি চালানো	guli cālānō
দেখানো	dekhano
বন্ধ করা	bôndhô kôra
বসা	bôsha
বসা	bôsha
ফোলা	fola
সাঁতার	sāṁtār
শেখান	shekhan
চিন্তা	cinta
বোঝা	bojha
কাঁদা	kamda
কান্দা	kanda
ক্রন্দন করা	krôndôn kôra
ভিজা	bhija
বায়ু	baẏu
রাঁধুনি	ramdhuni
বোতল	botôl
আচরণ	acôrôn
পরিবর্তন	poriborton
চিরুনি	ciruni
মেঘ	megh
মস্তিষ্ক	môstishkô
বিশ্লেষণ	bisleshôn
নঙ্গর	naṅgara
নোঙ্গর	nōṅgara
আন্তর্জাতিক ধ্বনিমূলক বর্ণমালা	
কয়লা	kôẏôla
পিঠা	piţha
সাফ	saph
পরিষ্কার	pôrishkar
পরিস্কার	pôrishkar
লোহা	lohā
পেট	peţ
জীবাণু	jibanu
বরফ	bôrôf
হ্রদ	hrad
দরজা	dôrja
ফটক	phaṭaka
পার্থক্য	parthôkkô
তফাত	tôfat
নোংরা	nonra
ছাগল	chagôl
সমতল	sômôtôl
বেহালা	behala
গিটার	giţar
পিয়ানো	piẏano
অক্টোপাস	ôkţopas
শুক্রাশয়	shukrashôẏ
বীচি	bici
প্রজাপতি	projapoti, prajapati
উট	uţ
গাধা	gadha
খরগোশ	khôrgosh
শশ	shasha
শুওর	shuor
শিয়াল	shiẏal
এক্সএইচটিএমএল	eks-eic-ţi-em-el
লেজার	lejar
মডেম	môḑem
খ্রীষ্টান	khrishţan
খ্রীষ্টান	khrishţan
থালা	thala
হৃৎপিন্ড	hritpinḑô
হার্ট	harţ
হৃদয়	hridoy
অন্ধকার	andhôkar
মৃত	mritô
মৃত্যু	mrittu
মরন	môrôṇ
যদি	jôdi
কিনা	kina
কি না	ki na
বিপদ	bipôdô
তালিকা	talika
দীর্ঘ	dirghô
লম্বা	lômba
লম্বা	lômba
কম	kôm
প্রশস্ত	prôshôstô
উচ্চ	uccô
জীবন্ত	jibôntô
জীবন	jibôn
প্লাজমা	plazma
গুরুত্বপূর্ণ	guruttopurno
দরকারী	dorkari
ঘর	ghôr
হাসপাতাল	haspatal
ডাক্তার	ḑaktar
ছুরি	churi
চাকু	caku
ধাতু	dhatu
পর্বত	pôrbôt
নুন	nun
চিনি	cini
শর্করা	śôrkôrā
লেজ	lej
বেত	betō
অসি	asi
ভারী	bhari
যকৃৎ	jôkrit
পুরোনো	purono
পুরোনো	purono
প্রবীণ	prôbin
নদী	nadi
ভয়	bhôẏ
ভয় করা	bhôe kôra
পাকস্থলী	pakôsthôli
পেট	peţ
চোষা	cosha
ধাক্কা দেওয়া	dhakka deoa
ধাক্কানো	dhakkano
ধাক্কা	dhakka
গুনতি	gunti
গণনা	gôṇna
বালু	bali
কুয়াশা	kuẏasha
ধোঁয়া	dhõẇa
কেউ না	keu na
সবাই	shôbai
অনেক	anek
বরফ	bôrôf
লিফট	liphţ
ইউরোপীয় ইউনিয়ন	i'uropiyô i'uniyôn
চাবি	cābi
ইঞ্জিন	injin
সাহস	shahôs
ইউরোপ	iurop
ইহুদি	ihudi
ইহুদি	ihudi
শিরা	shira
দুঃখিত	duḥkhito
মাফ করবেন	māf korbēn
সরি	sori
রাজতন্ত্র	rajtôntrô
রাষ্ট্র	rashţrô
ফেডারেশন	pheḑareshôn
অঙ্গ	ônggô
জীব	jib
আফ্রিকা	aphrika
অ্যান্টার্কটিকা	ôyanṭarkôţika
এশিয়া	eshiẏa
নির্বাচন	nirbacôn
কমিউনিজম	kômi'unijôm
সাম্যবাদ	samyôbad
সামুরাই	samura'i
চূর্ণ	curn
শিশির	shishir
হাতুড়ি	hatuŗi
বেশ্যা	beshya
দাড়ি	daŗi
ইউক্রেনীয় ভাষা	Iukreniẹ bhasha
রসায়ন	rôsayôn
আমেরিকান	āmērikān
মার্কিন	mārkin
মার্কিনী	mārkinī
অ্যানিমে	ênime
মাঙ্গা	manga
দল	dôl
পার্টি	parţi
পার্টি	parţi
পার্টি করা	parţi kôra
মূল্য	mulyô
উদজান	udjān
হিন্দি	Hindi
কৃষ্ণগহ্বর	krishnôgôhbôr
কৃষ্ণবিবর	krishnôbibôr
ব্ল্যাকহোল	blêk-hol
ব্ল্যাক হোল	blêk hol
প্রোটন	proţôn
বোকা	boka
কন্নড় ভাষা	kônnôŗô bhasha
পাসওয়ার্ড	pas'oẏarḑ
তার	tar
চাওয়া	caoẇa
সোফা	sopha
গন্ডার	ganḍār
কফি	kaphi
প্রাতরাশ	pratôrash
লিঙ্গ	ling
ফড়িং	phôŗing
গ্রহাণু	grôhanu
পীচ	pic
মেয়নেজ	mēẏanēja
ফিলিস্তিন	philistin
প্যালেস্টাইন	pyalesţa'in
ব্রিটেন	briţen
ঘুষ	ghush
হস্তমৈথুন	hôstômoithun
হাত মারা	hat mara
কৃত্রিম	kritrim
কৃত্রিম	kritrim
রুমাল	rumal
খুশি	khushi
কিডনি	kiḑni
বৃক্ক	brikkô
অন্ত্র	ôntrô
সতর্ক	sôtôrkô
তথ্য	tôtthô
খেলা	khela
উদ্দ্যান	uddyān
যবক্ষারজান	yabakṣārajān
লবণক	labanak
অম্লজান	amlajān
বিমান	bimāna
খপোত	khôpot
উড়োজাহাজ	uŗojahaj
বিমান	biman
আকাশযান	akashôyan
কাগজ	kagôj
সাহায্য	shahajjô
সাহায্য করা	shahajjô kôra
পদার্থবিজ্ঞান	pôdarthôbiggan
পদার্থবিদ্যা	pôdarthôbidya
স্তন	stôn
অভিস্রবণ	abhisrabaṇ
জানালা	janala
হার্ডওয়্যার	harḑ-owar
হার্ডওয়্যার	harḑ-owar
স্মৃতি	smriti
একুশ	ekush
বাইশ	baish
তেইশ	teish
চব্বিশ	chôbbish
পঁচিশ	pỗchish
ছাব্বিশ	chabbish
সাতাশ	shatash
আঠাশ	athash
উনতিরিশ	unôtirish
খোঁজা	khõja
সংসদ	sônsôd
বিশ্ববিদ্যালয়	bishbôbidyalôẏô
মাকড়সা	makôŗsha
ফটোগ্রাফি	fôţografi
ফটোগ্রাফী	fôţografi
পশুপালক	paśupālaka
ডাকা	ḑak
সাগর	shagôr
সমুদ্র	shômudrô
প্লিজ	pliz
প্লীজ	pliz
ডাউনলোড	ḑa'unloḑ
ডাউনলোড করা	ḑa'unloḑ kôra
ডাউনলোড	ḑa'unloḑ
জরৈফ	jiraph
মহাবিশ্ব	môhabishbô
নর্তকী	nôrtôki
প্যারিস	Pêris
মস্কো	môsko
লন্ডন	lanḑan
গোলক	golôk
গোলক	golôk
বাইসাইকেল	ba'isa'ikel
সাইকেল	sa'ikel
মোটরসাইকেল	moţôrsa'ikel
হিলিয়াম	hiliẏām
দুধ	dudh
পালক	palôk
অঙ্গার	aṅgār
মিটার	miţar
উপহার	uphar
জ্বালানি	jbālāni
বাঁধ	bãdh
সিগারেট	sigareţ
পরমাণু	pôrômāṇu
মাইল	ma'il
অ-	a-
লিথিযাম	lithiyām
বোরন	bōran
ফ্লুরিন	phlurin
নিয়ন	niẏan
ম্যাগনেসিয়াম	myāgnēsiẏām
অ্যালুমিনিয়াম	æyāluminiẏām
দস্তা	dôsta
ঘনাতু	ghanātu
বাস	bas
মর্যাদা	môryada
বিদ্যালয়	bidyālaẏa
সেক্স	seks
লিঙ্গ	ling
ডিউটেরিয়াম	ḑi'uţeriyam
আধা	adha
উপমক্ষিকা	upômôkshika
ভাল	bhāla
পোকা	poka
কোদাল	kodal
কন্ডম	kônḑôm
শহর	shôhôr
নগর	nôgôr
দোকান	dokan
উপাধি	upadhi
বুদ্ধিমান	bud'dhimāna
ঘাম	gham
শিক্ষা	shikkha
শিক্ষা	shikkha
কাঁটাচামচ	kanţacamôc
রেস্টুরেন্ট	resţurenţ
রেস্তোরাঁ	restoram
টেলিভিশন	ţelibhishôn
টেলিভিশন সেট	ţelibhishôn seţ
বাষ্প	basp
ভাপ	bhap
ধন্যবাদ	dhônnôbad
নিরাপত্তা	nirapôtta
প্রব্লেম	prôblem
অসীম	asīma
খ্রিস্ট ধর্ম	khrisţ dhôrm
অলৌকিক	ôloukik
খ্রীষ্ট	khrishţô
তীর	tir
বন	bôn
জঙ্গল	jônggôl
ক্যাশ	kæsh
নগদ	nôgôd
ধোয়া	dhoa
ধোওয়া	dhoa
লাঞ্চ	lāñca
চুম্বন করা	cumbôn kôra
চুম্বন	cumbôn
ভদকা	bhôdka
নাভি	nabhi
চার্লস	charlôs
ক্রিস্টোফার	krisţophar
ড্যানিয়েল	Ḑêniẏel
জাহাজ	jahaj
ভিসা	bhisa
জন্মদিন	jônmôdin
জন্মদিন	janmadin
তাগালোগভাষা	tāgālōga bhāṣā
সূচি	suci
সুই	su'i
ক্রিসমাস	krismas
অস্ত্রবিরতি	ôstrôbirôti
নন্দ	anondo
বৈশিষ্ট্য	boishishţţô
মুভি	muvi
মুভী	muvi
ফিল্ম	philm
সিনেমা	sinema
আয়তক্ষেত্র	āẏatakṣētra
কলনবিদ্যা	kalanbidyaa
প্যারাশুট	pærashuţ
ইনফ্লুয়েঞ্জা	inphluyenja
কারখানা	karkhana
ফ্যাক্টরী	phyakţôri
পেট্রল	peţrôl
নখ	nôkh
ব্যাংকক	bæṃkôk
বার্লিন	barlin
প্লাস্টিক	plasṭik
হাভানা	havānā
অর্থনীতি	ôrthôniti
চৌর্যোন্মাদ	cauryōnmād
জাকার্তা	Jakarta
জেরুসালেম	jerusalem
কাবুল	Kabul
কাঠমান্ডু	kaṭhmanḍu
কিয়েভ	kiẏebh
রিয়াদ	riyad
সানফ্রান্সিস্কো	sanphransisko
সিওল	siol
ত্বক	tbôkô
তেহরান	Tehrān
তেহ্রাণ	Tehrāṇ
টোকিও	ţoki'o
ওয়ার্সা	oyarsa
ত্রিংশত্তম	trinśattama
চত্বারিংশত্তম	catbārinśattama
পঁচাশত্তম	pam̐cāśattama
ষষ্টিতম	ṣaṣṭitama
অশীতিতম	aśītitama
নবতিতম	nabatitama
একাশি	ekashi
পপকর্ন	pôpkôrn
ভুট্টার খই	bhuţţar khô'i
গ্রাম	gram
কিছু না	kichu na
কুরআন	kur-an
অনুবাদক	ônubadôk
টয়লেট পেপার	ţoẏleţ pepar
কামার	kamar
অনুবাদক	ônubadôk
আপনি কেমন আছেন?	apni kêmôn achen?
তুমি কেমন আছো?	tumi kêmôn acho?
তুই কেমন আছিস?	tui kêmôn achish?
সংবাদপত্র	shôngbadpôtrô
কাঁচ	kãc
গ্লাস	glas
শক্তিশালী	shôktishali
বাংলাদেশী	Bangladeshi
বাংলাদেশি	Bangladeshi
আইসক্রীম	a'isakrim
সমূদ্রতট	shômudrôtôṭ
লেসবিয়ান	lesbian
লেসবিয়ান	lesbian
হকি	hôki
কিলো	kilō
বর্মী ভাষা	bôrmi bhasha
আপনার নাম কী?	apnar nam ki?
তোমার নাম কী?	tomar nam ki?
আমার নাম	āmār nam...
টয়লেটটি কোথায়?	ṭôelēṭṭi kōthāẏa?
আপনার নাম কি?	āpnār nām ki?
তোমার নাম কি?	tōmār nām ki?
লক্ষ্য	lakshya
ছায়া	chaẏa
শ্যাডো	shaḑo
কর্মী	kôrmi
বিজলী	bijôlī
স্তনবৃন্ত	stônbrintô
যৌনসঙ্গম	jounôsôngôm
ঘড়ি	ghôŗi
ফটোগ্রাফ	fôţograf
ফটো	fôţo
রসুন	rôsun
দাঁড়ানো	dãŗano
খলিফা	khôlipha
সুগন্ধি	sugôndhi
বানমাছ	bāna-mācha
আদা	ādā
আদা	ādā
ছত্রাক	chôtrak
অদৃশ্য	ôdrishyô
সোফিয়া	Sophiyā
ঘটনা	ghôţna
ঘটনা	ghôţna
পেঁয়াজ	pẽyaj
আল্লাহ	allah
আইনজীবি	a'inôjibi
সরীসৃপ	sôrisrip
কৃষ্ণসীস	kr̥ṣṇasīs
চাকা	caka
টায়রা	ţayra
হল্যান্ড	hôlyanḑ
নেদারল্যান্ডস	nedarlyanḑôs
ঠোঁট	ţhõţ
গন্ধ	gôndhô
শিঙা	shinga
কিছু একটা	kichu ekţa
দুর্বল	durbôl
চিতা	citā
চিতাবাঘ	citabagh
সিংহ	singha
জলহস্তী	jôlôhôsti
পতাকা	pôtaka
ফ্ল্যাগ	flêg
বিছা	bichA
বাঁদর	bãdôr
কুমীর	kumir
উপত্যকা	upôttôka
ইস্পাত	ispat
চা	ca
চা	ca
টিয়া	ţia
ভার্চুয়াল	varcuẇal
আলু	alu
ঐতিহাসিক	oitihasik
ইতিহাস	itihas
ঐতিহাসিক	oitihasik
ফুটি	phuṭi
সাফল্য	saphôlya
হাই তোলা	ha'i tola
হাই	ha'i
রেইকিয়াভিক	rēikiẏābhik
তামাক	tamak
তামাক	tamak
জার	jar
পত্রিকা	pôtrika
চিংড়ি	cinri
কালি	kāli
ভুত	bhut
হাগু	hagu
ভগাঙ্কুর	bhôgangkur
স্নুকার	snukar
জলদস্যু	jôlôdôsyu
আভিধানিক	ābhidhānik
ছোট	choṭô
পাতা	pata
নেকড়েবিশেষ	nēkaṛēbiśēṣa
চোর	cor
বাংলা	Bangla
বাংলা ভাষা	Bangla bhasha
উর্দু	urdu
ব্যাক্টেরিয়া	bêkţeriẏa
লরি	lari
ট্রাক	ţrak
আঞ্চলিক	ancôlik
আম	ām
দড়ি	daŗi
হসন্ত	hasanta
নীহারিকা	niharika
টেবিল	ţebil
ট্রাম	ţram
দুঃখ	duḥkh
বেদনা	bedôna
সুখ	shukh
সুখ	sukha
হীরা	hira
পোশাক	poshak
পারস্য	parôsyô
বিবাহ	bibah
ব্যক্তিগত কম্পিউটার	bêktigôtô kômpiuţar
মরুভূমি	môrubhumi
খালি	khali
রেঙ্গুন	rengun
দৈহিক	doihik
অনিবার্য	ônibarjô
একই	ēka'i
হলুদ	halud
লাতিন আমেরিকা	lātin āmērikā
মোটরগাড়ি	moṭôrgaŗi
ড্রাগন	ḑragôn
তোপ	top
সংস্কৃতি	sôngskriti
বোলতা	bolta
ব্যাঙ	byan
কুকুরছানা	kukurchana
বাঘিনি	baghini
পতঙ্গ	pôtông
দূরভাষা	doorbhaashaa
ফোন	phon
মুরগি	murgi
সূত্র	sutrô
কীট	kiţ
বীজ	bij
মূল	mul
ক্যান্সার	kænsar
ছাল	chal
নখ	nôkh
রেল গাড়ী	rel gaŗi
গাড়ী	gaŗi
প্রতিবেশী	prôtibeshi
পেয়ালা	peẏala
মূর্খ	murkhô
নাক ডাকা	nak ḑaka
ঠিকানা	thikana
শিক্ষা করা	shikkha kôra
শিক্ষা	shikkha
গ্রন্থাগার	grônthagar
মটর	môţôr
টিকেট	ţikeţ
রসিদ	rasid
অন্ত্র	ôntrô
ভূগোল	bhugol
জ্যাম	jæm
সমুদ্র	sômudrô
মহাসমুদ্র	môhasômudrô
পাসপোর্ট	pasporţ
দূরবীন	durbin
ফুসফুস	phusphus
আত্মা	atma
বুদ্ধ	buddhô
বৌদ্ধ ধর্ম	bouddhô dhôrmô
বিগ বেন	big ben
গোঁফ	gomph
ট্যাপিওকা	ṭyāpi'ōkā
নববধূ	nôbbôdhu
এরপর	erpôr
এর পর	er pôr
এরপরে	erpôre
এর পরে	er pôre
তারপর	tarpôr
তার পর	tar pôr
তারপরে	tarpôre
তার পরে	tar pôre
তাল	tal
সতর্কীকরণ	sôtôrkikôrôn
জীবন্ত	jibôntô
বিবাদ	bibad
হাঙ্গর	hanggôr
হাঙর	hangôr
তিমি	timi
রাষ্ট্রদূত	rashţrôdut
আমেরিকা	amerika
বিশ্লেষণ করা	bisleshôn kôra
আশ্চর্য	ashcôrjô
মৃতদেহ	mr̥tōdēhō
লাশ	lāś
মড়া	maṛā
শব	śab
রবর	rôbar
মোমবাতি	mombāti
খরা	khôra
সার্বো-ক্রোয়েশীয়-বসনীয় ভাষা	Sarbo-Kroeshiẹ-Bôsniẹ bhasha
বিশ্রী	bisri
আন্দামান দ্বীপপুঞ্জ	āndāmān dbīppuñj
শত্রু	shôtru
দুশমন	dushmôn
জ্বালাতন	jalatôn
নৃবিজ্ঞান	nr̥bijñān
আত্মহত্যা	atmôhôtya
পেশী	peshi
বড়	bôŗô
গাজর	gājar
ছাদ	chad
গ্রন্থি	grônthi
চুলা	cula
ব্যবহার করা	bêbôhar kôra
আলোচনা	alochona
প্রোগ্রামিং ভাষা	programer bhasha
শসা	shôsha
সাধারণভাবে	Sadharanbhabe
প্রস্রাব	prôsrab
মূত্র	mutrô
মলদ্বার	môldar
পুটকি	puţki
প্রতি	prôti
হোটেল	hoţel
সমকামিতা	sômôkamita
উভকামিতা	ubhôkamita
ফটো	fôţo
ব্যয়বহুল	byôẏôbôhul
প্রিন্টার	prinţar
রক্তাক্ত	rôktaktô
ছুটির দিন	chuţir din
উদ্ভিদবিজ্ঞান	udbhidbijñān
মাইক্রোগ্রাম	maikrogram
টুপি	ţupi
দুঃখিত	duḥkhit
সুপ	supa
সাবমেরিন	sabmerin
শুক্রাণু	shukranu
বীর্য	birjô
শিলাবৃষ্টি	shilabrishţi
উত্তম পুরুষ	uttôm purush
মধ্যম পুরুষ	môddhôm purush
প্রথম পুরুষ	prôthôm purush
পরী কাহিনী	pôri kahini
বেদাগ ইস্পাত	bedag ispat
স্বাস্থ্য	sbasthÿô
আরোগ্য	arogya
কুইডিচ	ku'iḑic
কিডিচ	k'iḑic
উল্কি	ulki
বিদেশি	bideshi
বিদেশী	bideshi
মোজা	moja
চামচ	camôc
গালিচা	galica
শুভ নববর্ষ	śubha nababarṣa
নববর্ষ	nôbôbôrshô
নতুন বছর	nôtun bôchôr
আলোক বর্ষ	ālōk barṣ
প্রোগ্রাম	program
দ্বীপপুঞ্জ	dbīpapuñja
বীর	bir
আদর্শ পুরূষ	ādarś purūṣ
চারিত্রিক	caritrik
পর্নোগ্রাফি	pôrnographi
ঝাড়ু	jhaŗu
দূরবীন	durbin
নবী	nôbi
বেল্গ্রেড	Belgre.d
উপন্যাস	upôn'yash
সবকিছু	shôbkichu
সব জায়গা	shôb jaẹga
কোথাও না	kothao na
কোথাও	kothao
মানুষ	manush
মানব	manôb
ইসলামী	islami
ইসলামি	islami
চতুর	côtur
শয়তান	shôytan
তরঙ্গ	tôrônggô
সুস্বাদু	susbadu
জার্মান সাম্রাজ্য	jārmāna sāmrājya
সাহসী	sahôsi
অনেক	ônek
বহু	bôhu
অপেক্ষা করা	ôpekha kôra
চোরাবালি	corabali
পছন্দ করা	pôchôndô kôra
মত	môtô
শিখ	
অভ্যুত্থান	ôbhyut'than
পোশাক	poshak
চেষ্টা করা	ceshţa kôra
দাঁড়ানো	dãŗano
সৈনিক	sainik
হাত মারা	hat mara
বিবাহ	bibah
করোটি	karoţi
গায়ক	gaẏôk
ছাত্র	chatrô
প্রবেশ করা	prôbesh kôra
স্বাধীনতা	shadhinôta
আটাশি	aţashi
শিক্ষক	shikkhôk
অবশ্য	ôbôshyô
অবশ্যই	ôbôshyô'i
শীঘ্রই	shighrô'i
ভ্যাম্পায়ার	bhæmpayar
হসন্ত	hôshonto
চন্দ্রবিন্দু	côndrôbindu
পঁয়তাল্লিশ	pỗẏtallish
পেরিনিয়াম	periniẏam
মাতাল	mātāla
ফ্যাক্স	phæks
ভাইরাস	bha'iras
দরজা	dôrja
গেট	geţ
ঘৃণা করা	ghrina kôra
ঢুকানো	ḑhukano
ঢুকানো	ḑhukano
বিবর্তন	bibôrtôn
নিলাম	nilāma
বৈদেশিক	boideshik
বৈদেশিক	boideshik
নির্বাণ	nirbāṇa
নির্বাণ	nirbāṇa
প্রশ্ন	prôshnô
চশমা	côshma
অপেক্ষা করা	ôpekha kôra
গাঁজাখোর	gajakhor
যোনি	yoni
পৃষ্ঠা	prishţha
পাতা	pata
কোটনা	koţna
ট্যাক্সি	ţêksi
ক্যাব	kêb
মেস	mēs
রান্নাঘর	rannaghôr
বিগ্গানী	biggani
খন্ড	khônḑô
কিছুক্ষন	kichukkhôn
নিবার্য	nibarjô
আচরণ	acôrôn
আচরণ	acôrôn
রায়ান	rāẏān
কলকাতা	Kôlkātā
মেরি	meri
পক্ষীবিশেষ	pakṣībiśēṣa
শবাগার	shôbagar
গণিত	gaṇit
আয়না	aẏna
আরশি	āraśi
দর্পণ	darpaṇ
চুরি	curi
কঙ্কাল	kônkal
ড্রাইভার লাইসেন্স	ḑra'ibhar la'isens
ফ্রিজ	phrij
কত	kôtô
রিচার্ড	Ricarḑ
গ্যাস স্টেশন	gæs sţeshôn
বগল	bôgôl
গুহা	guha
সীম	sim
শিম	shim
বিন্দু	bindu
গলদা	gôlda
কাঁকড়া	kam̐kôŗa
প্রতিষ্ঠাতা	prôtishţhata
শিল্পী	śilpī
শিল্পী	śilpī
কৃষিকার্য	krishikaryô
কবর	kôbôr
পঁচাত্তর	pỗcattôr
মূর্খ	murkhô
আধুনিক	adhunik
আশা	asha
আশা করা	asha kôra
আটাত্তর	aţattôr
পুতুল	putul
ডলফিন	ḑôlphin
হনূমান	hanūmān
আবেগ	abega
জনসংখ্যা	jônôsônkhya
এক	ek
মূর্খ	murkhô
বক্সিং	bôksin
সনি	soni
ঘৃণা	ghrina
স্কার্ফ	skarphô
সাবান	saban
কালজামজাতীয় ফল	kālajāmajātīẏa phala
সমাজ	sômaj
এভাবে	ebhabe
ডুমুর	ḍumur
তরমুজ	tôrômuj
সন্ত্রাসবাদী	sôntrasôbadi
স্টেশন	sţeshôn
ভুরু	bhuru
টিকিট	ṭikiṭ
স্বীকৃতি	shikriti
জলজ	jôlôj
কারাগার	karagar
জলবায়ু	jôlôbaẏu
রূমাল	rumal
কুর্দিস্তান	kurdistan
গলা	gôla
রিকশা	riksha
ইন্ডস্ট্রী	inḑôsţri
শিক্ষা	shikkha
 ঢাল	ḑhal
তিম	etim
কৃষ্ণ সাগর	krishn shagôr
হঠাত্	hôţhat
বিসর্গ	bisorgo
আবিষ্কার	abishkar
কেটলি	keţli
খবর	khôbôr
খবর	khôbôr
মূর্তি	murti
ছেলে	chele
গ্লুকোজ	glukoz
-হীন	-hin
গন্ধ	gôndhô
তলা	tôla
সমুদ্র	shômudrô
ধ্বনিমূলক	dhwônmūlok
অয়স্কান্ত	aẏaskānta
মৃত্তিকা	mr̥ttikā
গাঁজা	gañja
প্রধান শিক্ষক	prôdhan shikshôk
চাষী	cashi
বিমানবন্দর	bimanbôndôr
প্রায়ই	prayô'i
অঞ্চল	ôncôl
চুক্তি	cukti
নৃত্য	nrityô
নাচা	naca
পাওয়া	paoẇa
কঠিন	kôţhin
উৎকৃষ্ট	utkrishţô
ফাটাফাটি	faţafaţi
গাঁজা	gãja
ডিস্ক	ḑisk
সহজ	sôhôj
অপেরা	ôpera
পার্সিফোন	parsiphon
দই	dô'i
ক্রীড়া	kriŗa
শ্তভযাত্রা	śtabho yātrā
ধার্মিক	dharmik
বীর্য	birjô
গ্রেট ব্রিটেন	greṭ briṭen
যাত্রী	yatri
ইমাম	imam
প্রজাতন্ত্রী চীন	prajātantrī cīn
গাল	gal
রাগমোচন	ragmocôn
স্নান	snan
ধারাস্নান	dharasnan
ঝরনা	jhorna
ধারাস্নানের যন্ত্র	dharasnaner yantra
বন্ধুত্ব	bôndhutbô
তারামাছ	taramach
তক্ষক	takṣaka
খান	khan
ফোটন	phoţôn
তৌরাত	taurat
দুপেয়ে	dupeye
দুপেয়ে	dupeye
সতর্কীকরণ	sôtôrkikôrôn
ঝুলনা	jhulna
দোলনা	dolna
বিবাদ	bibad
মৌলিক	moulik
মোটা	moṭa
দুঃখ	duḥkh
বেদনা	bedôna
কল্পনা	kôlpôna
অভিবাসন	ôbhibasôn
স্বাধীনতা	sbadhinta
মই	ma'i
জোঁক	jonk
ঝিনুক	jhinuk
মুক্তা	mukta
খুর	khur
লালা	lala
চিত্কার করা	citkar kôrā
সফল	sôphôl
কামাসক্ত	kamasôktô
কামুক	kamuk
তৃষ্ণা	tr̥ṣṇā
তোয়ালে	toẏale
বিবাদ	bibad
বিবাদ	bibad
কবিতা	kôbita
পদ্য	pôdyô
কবিতা	kôbita
কবি	kôbi
সাহিত্য	sāhitya
বার্তা	barôt
লক্ষ	lokkho
গুল্ম	gulmô
কমরেড	kamreḑ
সুপ্রভাত	shuprobhat
আন্তর্জাতিক	antôrjatik
পরজীবী	pôrôjibi
মেঘ	megh
কাল্পনিক	kalponik
শয়তান	shôytan
ইহুদি ধর্ম	ihudi dhôrmô
ইহুদি	ihudi
কারাওকে	kara'oke
নান	nan
দক্ষিণ পূর্ব এশিয়া	dakṣiṇa pūrba ēśiẏā
পুলিশ	pulish
ভ্যাকুয়াম ক্লিনার	bækuẏam klinar
মক্কা	môkka
শ্যাম্পু	shæmpu
হঠাত্	hôţhat
তুষারধবল	Tuṣāradhabala
বোসন	bosôn
বহুল	bôhul
সন্ধ্যা	sandhyā
নারীবাদ	nārībād
কেচাপ	kecap
প্রার্থনা করা	prarthôna kôra
প্লীহা	pliha
আগ্নেয়গিরি	agneẏôgiri
জলা	jôla
অগ্রপথিক	agropothik
জঙ্গল	jônggôl
প্রতীকী ভাষা	protiki bhasha
ডিলডো	ḑilḑo
ডিল্ডো	ḑilḑo
অনিবার্য	ônibarjô
জিনস	jinôs
আশ্রয়	Āśraẏa
রুবল	rubôl
বিপ্লব	biplôb
পিয়ং ইয়াং	piyômiyam
গর্ভবতী	gôrbhôbôti
বালিশ	balish
বর্ণালীমাপক	bôrnalimapôk
ছড়া	chôḑa
কান্ধ	kandh
অলৌকিক	ôloukik
আউন্স	ā'unsa
জ্যামিতি	jyāmiti
সিন্ধুঘোটক	shindhughoţôk
সুড়ঙ্গ	surông
ব্যাকপ্যাক	bækpæk
পালি	pali
বিশেষ	bishesh
ইলেকট্রনিক্স	ilekţrôniks
হলিউড	hôli'uḑ
হলিউড	hôli'uḑ
বলিউড	baliuḍ
বোরকা	borka
বাজার	bajar
সীমানা	simana
বারুদ	barud
আকাশগঙ্গা	akashgônga
হিন্দুধর্ম	hindudhôrm
ঢোল	ḑhol
উপবৃত্ত	upabr̥tta
কোণার	konar
কোণ	kon
ওয়েবসাইটি	oẹb-saiţ
বিয়াল্লিশ	biẏallish
ডালিয়া	ḑalia
আইওয়া	āiōẏā
নিউ মেক্সিকো	ni'u mēksikō
ওয়াশিংটন	ōẏāśiṇṭan
চতুর	côtur
প্রাণপদার্থবিদ্যা	prāṇpadārthbidyā
রক্ষা	rôksha
কাশ্মীর	kāśmīr
গর্ভধারণ	gôrbhôdharôṇ
স্পুতনিক	sputnik
প্রথা	prôtha
সতর্কীকরণ	sôtôrkikôrôn
সতর্কীকরণ	sôtôrkikôrôn
মৌলিক	moulik
মৌলিক	moulik
অনেক	ônek
বহু	bôhu
সংস্করণ	sanskaraṇa
অনুবাদ	anubāda
যমজ	yômôj
প্যাগোডা	pægoḑa
জিরা	jirā
রেটিনা	reţina
অন্ডকোষ	ônḑôkosh
অণ্ডকোষ	ônḑôkosh
হার	har
ভ্যাক্সিন	bhyaksin
টীকা	ţika
দিনলিপি	dinalipi
জাদুঘর	jadughôr
রক্তচাপ	rôktôcap
কখনো সখনো	kakhôno kakhôno
তাইপে	tāipe
স্বাক্ষর	sbakshôr
ল্যাম্প	læmpô
কুষ্ঠ	kushţhô
কুঠ	kuṭh
সিনেমা	sinema
দেশভক্ত	deshôbhôktô
চুরূট	curūṭ
দুরিয়ান	duriẏāna
দুরিয়ান	duriẏāna
ধানজমি	dhānajami
রোমান সাম্রাজ্য	roman samrajyô
কিনার	kinar
তীর	tir
জিহাদ	jihad
শিকাগো	śikāgō
স্থির করা	sthir kôra
আমন্ত্রণ করা	amôntrôn kôra
উপাস্থি	upasthi
কোমলাস্থি	komôlasthi
লুইস	lu'is
সাহায্য	shahajjô
বস্টন	bôsţôn
হিটলার	hiţlar
আডল্ফ হিটলার	aḑolph hiţlar
জ্বালাতন করা	jalatôn kôra
জ্বালাতন করা	jalatôn kôra
কলম	kalama
ঐতিহ্য	aitihya
রীতি	riti
প্রথা	prôtha
কার্নিভাল	karnibhal
মুফতি	muphti
বেশ্যালয়	beshyalôy
কৃত্রিম	kritrim
অন্ধপ্রায়	ôndhôpraẏ
সাংস্কৃতিক	sangskritik
এলাকা	ēlākā
চিকিত্সা	cikitsā
আইনস্টাইন	āinasṭāin
কদাপি	kôdapi
জার্নালিস্ট	jarnalisţ
মানবজাতি	manbôjati
টুথব্রাশ	ţuthbrash
ওজোন	ojon
অজ’ন	ôjô'n
ক্যাফিন	kæphin
নিবার্য	nibarjô
অলিম্পিক গেমস	ôlimpik gemôs
অলিম্পিক্স	ôlimpiks
রাম	rām
বেইজিং	bē'ijin
পিকিং	pikin
সোভিয়েত ইউনিয়ন	sobhiyet i'uniyôn
পক্ষীবিজ্ঞান	pôkṣībijñān
লিগামেন্ট	ligamenţ
ডিম্বাশয়	ḑimbashôẏa
দামেস্ক	damesk
ওয়াশিং মেশিন	oẏashing meshin
তাপগতিবিজ্ঞান	tāpôgôtibijñān
জাগা	jaga
জাগানো	jagano
ওয়ালেট	oẏaleţ
মানিব্যাগ	manibæg
সতর্ক	sôtôrkô
সতর্কীকরণ	sôtôrkikôrôn
রবার	rôbar
ভালভা	valva
শিক্ষামূলক	shikkhamulôk
আছে	ache
ঠেলাগাড়ি	thelagari
ঠেলা	thela
কঙ্গো প্রজাতন্ত্র	kôngo prôjatôntrô
আঞ্চলিক	ancôlik
রক্তশূন্যতা	rɔktɔśūnyɔtā
ডাকিনীবিদ্যা	ḍākinībidyā
মোবাইল ফোন	mōbāil phōn
মোবাইল	mōbāil
মুঠোফোন	muṭhōphōn
টেলিগ্রাম	ţeligram
উনসত্তর	unôsôttôr
জার্নালিজম	jarnalijôm
আখ	akh
উপদ্বীপ	upôdbip
উপসাগর	upôshagôr
দুঃস্বপ্ন	duḥsbôpnô
কুস্বপ্ন	kusbôpnô
মাইক্রোসফট	māikrosaphṭ
বাণিজ্য	baniyô
এলজিবিটি	ēljibiṭi
অনিবার্য	ônibarjô
আটানব্বই	aţanôbbôi
আটতিরিশ	aţtirish
আটষট্টি	aţshôţţi
সাতষট্টি	shatshôţţi
ছেষট্টি	cheshôţţi
পঁয়ষট্টি	pỗẏshôţţi
নিহাই	nihāi
মঞ্চনাটক	môncônaţôk
থিয়েটার	thiẏeţar
সতর্ক	sôtôrkô
সাবধান	sābdhān
তর্পণ	tarpaṇ
তর্পণ	tarpaṇ
বিকিনি	bikini
বাল	bal
নথিপত্র	nôthipôtrô
বত্রিশ	bôtrish
তেত্রিশ	tetrish
চৌঁতিরিশ	cõwtirish
পঁয়তিরিশ	pỗẏtirish
ছত্রিশ	chôtrish
সাঁইতিরিশ	shãitirish
উনচল্লিশ	unôcôllish
একচল্লিশ	ekcôllish
তেতাল্লিশ	tetallish
চুয়াল্লিশ	cuẏallish
ছেচাল্লিশ	chēcālliś
সাতচল্লিশ	sātacalliś
আটচল্লিশ	aţcôllish
উনপঞ্চাশ	unôpôncash
একান্ন	ekannô
বাহান্ন	bahannô
তিপান্ন	tipannô
চুয়ান্ন	cuyannô
পঞ্চান্ন	pôncannô
ছাপ্পান্ন	chappannô
সাতান্ন	shatannô
আটান্ন	aţannô
উনষাট	unôshaţ
একষট্টি	ekshôţţi
বাষট্টি	bashôţţi
তেষট্টি	teshôţţi
একাত্তর	ekattôr
বাহাত্তর	bahattôr
তিয়াত্তর	tiẏattôr
চুয়াত্তর	cuẏattôr
ছিয়াত্তর	chiẏattôr
সাতাত্তর	shatattôr
বিরাশি	birashi
তিরাশি	tirashi
চুরাশি	curashi
পঁচাশি	pỗcashi
ছিয়াশি	chiẏashi
সাতাশি	shatashi
উননব্বই	unônôbbôi
একানব্বই	ekanôbbôi
বিরানব্বই	biranôbbôi
তিরানব্বই	tiranôbbôi
চুরানব্বই	curanôbbôi
পঁচানব্বই	pỗcanôbbôi
ছিয়ানব্বই	chiẏanôbbôi
সাতানব্বই	shatanôbbôi
নিরানব্বই	niranôbbôi
উৎকোচ	uṯkoca
চাট্নি	cāṭni
শর্টস	shôrtôs
নির্জীব	nirjib
জীবনহীন	jibônhin
মৃত	mritô
পর্যটন	paryaṭan
সোয়েটার	soyeţar
মাতৃভাষা	matribhasha
ময়না	môyna
নখর	nôkhôr
অধ্যাপক	adhyāpaka
বাস্তুসংস্থান	bastusônsthan
বাস্তুতন্ত্র	bastutôntrô
শুয়ে পড়া	suẏe pôŗa
ভোজনশালা	bhōjanaśālā
যৌনতা	jounta
লেবিয়া মেজরা	lebiya mejora
লেবিয়া মাইনরা	lebiya mainora
রোনাল্ড	ronalḑ
অলৌকিক	ôloukik
বার্তাকু	bartaku
বার্তাকু	bartaku
পোখরাজ	pokharāj
শিক্ষা দেওয়া	shikkha deoa
আঁটো পাজামাবিশেষ	ām̐ṭō pājāmābiśēṣa
সন্ত্রাসবাদ	sôntrasôbad
পরিচায়ক	pôricaẏôk
পরিচায়ক	pôricaẏôk
স্যাটানিজম	syaţanijôm
সার্বিয়া	sarbiya
মূত্রনালি	mutrônali
মূত্রনালী	mutrônali
মন্টিনিগ্রো	mônţinigro
স্মৃতিসৌধ	smritisôudh
দ্য বিটল্‌স	dya biṭal‌s
বিটল্‌স	biṭal‌s
বক্ষাস্থি	bakṣāsthi
প্যারেড	pæreḑ
প্রাচীন গ্রিস	pracin gris
সুমেরু অঞ্চল	sumēru añcal
অগাস্ট	agāsṭ
বাইবেল	ba'ibel
কর্কট	kôrkôṭ
কর্কট	kôrkôṭ
আল্লাহ	Āllāha
গুগল	gūgal
আমি	ami
লাতিন ভাষা	latin bhasha
মঙ্গল	môngôl
বুধ	budh
চাঁদ	cãd
মাগোল	magol
ওব নদী	ob nadi
ওব	ob
সূর্য	surjô
টাইটানিক	ṭā'iṭānik
তুরস্ক	turôskô
কোলোন	kolon
নোকিয়া	nokiya
পেশিবহুল	peshibôhul
পেশীবহুল	peshibôhul
দূতাবাস	dutabas
হাজার	hajar
পৃথিবী	prithibi
আর্থ	arth
বঙ্গোপসাগর	Bôngopôshagôr
বঙ্গ	baṅga
বাংলা	bā.mlā
বঙ্গদেশ	baṅgadēś
কাউর	kaur
আমি	āmi ...
হেপাটাইটিস	hepeţa'iţis
অ্যারিওলা	êriola
হাইফেন	hā'iphēna
ফল	phôl
হ্যালোউইন	hyālōuina
বস্তু	bôstu
মুহাম্মাদ	muhammad
সুফিবাদ	sufibad
রমজান	rômôzan
আমির	amir
শরিয়া	shoriẏa
হোসেন	Hosen
নামাজ	nāmāj
সূরা	sura
আল্লাহু আকবার	allahu akbar
মূলা	Mūlā
ম্যাকডোনাল্ড’স	mækḑonalḑ's
প্রোস্টেট	prosţeţ
প্রোস্টেট গ্রন্থি	prosţeţ grônthi
বিষ্ণু	biṣṇu
উদ্দীপনা	uddipôna
উদ্দীপনা	uddipôna
রুশ ফেডারেশন	rushô pheḑareshôn
ইউরেশিয়া	iureshiẏa
সোপান	sopan
বোর্শ	bōrś
ব্যালে	byālē
শাড়ি	śāṛi
কিন্ডারগার্টেন	kinḑargarţen
সুইমিং পুল	su'imiṁ pul
দেবনাগরী লিপি	debnagri lipi
দেবনাগরী	debnagri
অ্যানথ্রাক্স	ênthraks
ভৌতিক	bhoutik
মাইক্রোফোন	ma'ikrophon
হার্ড ডিস্ক	hārḍ ḍisk
ফার্মেসি	pharmesi
দ্বিবীজপত্রী	dbibījpatrī
জয়চিহ্ন	jaẏacihna
ট্রফি	ṭraphi
বাংলা ভাষা	Bangla bhasha
পশ্চিমবাংলা	Pôshcimbangla
পশ্চিম বাংলা	Pôshcim Bangla
পূর্ববাংলা	Purbôbangla
পূর্ব বাংলা	Purbô Bangla
বঙ্গ	Bônggô
বাঙালি	Bangali
বাংলাদেশ	Bangladesh
বাংলাদেশী	Bangladeshi
বাংলাদেশি	Bangladeshi
টাকা	ṭaka
টাকা	ṭaka
বিডিএসএম	bi-ḑi-es-em
প্রজাতন্ত্রী তুরস্ক	prôjatôntri turôskô
পেরিক্লিস	???????s
বাক্‌লাভা	baklabha
মরিচ	morich
মূর্খ	murkhô
আগুন	āgun
পরোটা	paroţa
ব্রুনো	Bruno
ব্রুনো	bruno
ঈদ মুবারাক	id mubarak
ঈদ মোবারাক	id mobarak
ঈদ মুবারক	id mubarôk
ঈদ মোবারক	id mobarôk
দিলি	dili
ক্রেডিট কার্ড	kreḑiţ karţ
কারবালা	karôbala
ডার্ক চকলেট	ḑark côkôleţ
ভাষা	bhāṣā
যুক্তাক্ষর	juktakkhor
পাঠ্যপুস্তক	paţhyôpustôk
সামান্য	saman'yô
হিজড়া	hijŗa
চাবি	cabi
ছত্রাকবিজ্ঞান	chatrākbijñān
বেরোনো	berono
মাগরেব	magreb
বীচি	bici
সালাম	salam
গুই সাপ	gui shap
গুইসাপ	guishap
গোসাপ	goshap
গাজা	gājā
শয়তান	shôytan
মহারাজা	mahārājā
হালুয়া	halua
জুঁই	jumi
বেল	bela
মালতী	mālatī
নাগরিকতা	nagrikta
গাঁজা	gañja
গাঁজা	gañja
গজল	gôjôl
কে২	kē du'i
অন্ধবিন্দু	ôndhôbindu
টফি	ṭaphi
বাতিঘর	batighôr
ইনশাআল্লাহ্	insha'allah
নেকটাই	nekţai'i
সুলতান	sultan
ক্লিনিক	klinik
হয়	hay
মাদারবোর্ড	madarborḑ
সোমালিল্যান্ড	somalilænḑ
ছোটগল্প	choţôgôlpô
আবখাজিয়া	abkhajiẏa
কামরাঙ্গা	kamranga
খোঁজা	khõja
শিব	śiva
বাণিজ্যদূতাবাস	baṇijyadutabas
স্তালিন	stālin
ইত্যাদি	ittêdi
চুরি করা	curi kôra
পর্বতমালা	pôrbôtmala
জ্ঞান	jñān
দ্বার	dbara
সূর্য	sūryo
ধ্যান	dhyān
মস্তিষ্কহীন	môstishkôhin
মস্তিষ্কহীন	môstishkôhin
মুখোমুখি	mukhomukhi
পদ্ম	padma
পেঁপে	peṁpe
আমি জানি না	ami jani na
জানি না	jani na
কড়া	kaṛā
বইয়ের দোকান	bôiẏer dokan
দুঃখিত	duḥkhito
মাফ করবেন	māf korbēn
মাথা থেকে পা পর্যন্ত	matha theke pa pôrjôntô
দেয়ালের কান আছে	deẏalero kan ache
প্রেমহীন	premhin
ইয়াহু!	yāhu!
ইয়াহু	yāhu
কুসীদজীবী	Kusīdajībī
সালোয়ার	saloẏar
চুলচেরা বিচার	culcera bicar
দীপাবলি	dipabôli
অন্ধ্র প্রদেশ	Ôndhrô Prôdesh
অন্ধ্রপ্রদেশ	Ôndhrôprôdesh
আমি বুঝি না	ami bujhi na
বুঝি না	bujhi na
আপনি ইংরেজি বলতে পারেন?	apni ingreji bolte paren?
পাললিক শিলা	pālalika śilā
ক্যাট	kyaṭ
ভালবাসা	bhalôbasha
হায়দ্রাবাদ	Haẏdrabad
জেফারসন	jēphārsan
উত্তেজক	uttejôk
উলানবাটর	ulanbaţôr
ঢাকা	Ḑhaka
বিশকেক	bishkek
আভিধানিক	abhidhanik
দুই	dui
তিন	tin
চার	char
পাঁচ	pañch
ছএ	chhoe
সাত	shat
আট	att
নএ	noe
সুভা	subha
আস্তানা	astana
পোস্ট কোড	posţ koḑ
শহর	shôhôr
ভূগোল	bhugol
এরপর	erpôr
এর পর	er pôr
এরপরে	erpôre
এর পরে	er pôre
তারপর	tarpôr
তার পর	tar pôr
তারপরে	tarpôre
তার পরে	tar pôre
ঘন দুধ	ghana dudha
রুটি	ruṭi
ডালপুরি	ḑalpuri
নামহীন	namhin
অন্ধভাবে	ôndhôbhabe
অন্ধভাবে	ôndhôbhabe
পারিবারিক	paribarik
আমি জানতে চাই	ami jante cai
অন্ধভাবে	ôndhôbhabe
গঙ্গা	gônga
সুয়েজ খাল	suẏēj khāl
নাগোর্নো-কারাবাখ	nagorno-karabakh
হার্ভার্ড	hārbhārḍ
খাওয়া	khaoẇa
রক্তবমন	raktabaman
সাফারি পার্ক	saphari park
গুল	gul
সায়াম্	sāyām
ক্রিমিয়া	krimiẏā
লুঙ্গি	
আমি তোমাকে ঘৃণা করি	ami tomake ghrina kôri
আমি তোকে ঘৃণা করি	ami toke ghrina kôri
আমি তোমাদের ঘৃণা করি	ami tomader ghrina kôri
আমি তোদের ঘৃণা করি	ami toder ghrina kôri
আমি আপনাকে ঘৃণা করি	ami apnake ghrina kôri
আমি আপনাদের ঘৃণা করি	ami apnader ghrina kôri
মধ্য এশিয়া	môdhyô eshiẏa
দুনিয়া	duniya
নদী	nôdi
ইতিহাস	itihas
ধর্ম	dhôrmô
চাকা	cākā
তাজ মহল	taj môhôl
সিংহ	sinha
হৃদয়	hṛdoẏ
বিশাল	bishal
দোহা	doha
স্পার্টা	sparţa
অক্ষর	ôkshôr
মুখোমুখি	mukhomukhi
জাউ	ja'u
সতর্কীকরণ	sôtôrkikôrôn
ভোল্‌ফগাংক্‌	Bhōl‌phagāṅk‌
আমি তোমাকে ঘৃণা করি	ami tomake ghrina kôri
বিরিয়ানি	 biɾijɑːɳi
লাচ্ছি	lācchi
দেশের বাড়ি	desher baŗi
পুস্তক	pustôk
উমেদ	umēda
না	na
জি না	ji na
না	nā
স্বপ্ন	shôpnô
লক্ষ্মী	lakṣmī
নেপিদ	nepidô
ফাটাফাটি	faţafaţi
ঘোড়া	ghoŗa
লেনা	lena
লেনা নদী	lena nadi
রেসাস বানর	resas banôr
দৈনিক	doinik
সাপ্তাহিক	shaptahik
ঋতু	ritu
স্কাইলাইন	skailain
হায়দরাবাদ	Haẹdôrabad
বোড়ে	bore
ঘোড়া	ghora
গজ	gojo
নৌকা	nouka
মন্ত্রী	montri
রাজা	raja
চন্দা	canda
শরবত	shôrbôt
স্মার্টফোন	smarţphon
ভ্যান গখ	bhyan gôkh
ভিনসেন্ট ভ্যান গখ	bhinsenţ bhyan gôkh
আছে	ache
বারুদ	bārud
যান্ত্রিক ভাষা	yantrik bhasha
হেয়ার কন্ডিশনার	heẏar kônḑishnar
কিছু না কিছু	kichu na kichu
পোলাও	polao
জঙ্গল	jaṅgal
পূর্ব ইউরোপ	pūrba iurōp
ক্ষমাহীন	khômahin
সাখালিন	sākhālina
যৌনবিদ্যা	yaunbidyā
সব রাস্তা রোমের দিকে যায়।	Shob rasta Romer dike jay
জিরা	jirā
কেউটে	keuţe
হার্ড ডিস্ক	harḑ ḑisk
বন্যার পানি	bônnêr pani
প্রজাতন্ত্রী কোরিয়া	prajātantrī koriẏā
সালোয়ার	saloẏar
খবর	khôbôr
খানা	khana
তারা	tara
পূর্ণ	pūrṇa
তারকা	tarka
আঁখি	ãkhi
চোখের পাতা	cokher pata
কণীনিকা	kôninika
কনজাংটিভা	kônjangţiva
কর্নিয়া	kôrniẏa
পিউপিল	piupil
রেটিনা	reţina
স্‌ক্লেরা	sklera
এবং	ebông
জল	jôl
সেলেনা	selenā
তন্ত্র	tôntrô
খাওয়ানো	khaoẇano
আন্তর্জাল	āntarjāla
উইকিপিডিয়া	uikipiḍiyā
তক্তা	taktā
প্রদেশ	pradesh
রাজধানী	rajdhani
নিম	nim
লাস ভেগাস	Las Bhegas
বাঁশ	bãsh
রোজা	roja
ইনশাআল্লাহ্	insha'allah
দুনিয়ার মজদুর এক হও!	duniẏār majadur eka haō!
মন	mana
ভারত	bharôt
যৌনকর্মী	jounkôrmi
গণপ্রজাতন্ত্রী বাংলাদেশ	Gônôprôjatôntri Bangladesh
বাংলাদেশী	Bangladeshi
বাংলাদেশি	Bangladeshi
বঙ্গ	Bônggô
বাঙালি	Bangali
ঢাকা	Ḑhaka
-টি	-ţi
-রা	-ra
-এরা	-era
-গুলা	-gula
-গুলো	-gulo
পানি	pani
জলজ	jôlôj
দুশমন	duśman
সাবান	saban
কামোদ্দীপক অঙ্গপ্রত্যঙ্গ	kamoddipôk ôngôprôttôngô
পিতা	pita
দক্ষিণ এশিয়া	dôkhin eshiẏa
কুকুরছানা	kukurchana
ভাই	bhai
ভ্রাতা	bhrata
ভয়	bhôẏ
মাতা	mata
মা	ma
তারা	tara
হৃদয়	hṛdoẏ
নাম	nam
সূর্য	surjô
দাঁত	dānta
যুগ	yuga
জোয়াল	jōẏāla
পূর্ণ	pūrṇa
পাঁচ	pāṁc
ছয়	chay
সাত	shat
আট	aṭ
নয	nay
নএ	noe
দশ	dôsh
শত	śata
দুই	dui
তুমি	tumi
হয়	hay
দীর্ঘ	dīrgha
দেবর	dēbara
দশ	dôsh
বায়ু	baẏu
হাঁস	hãs
দাঁত	dānta
নাম	nam
ওষ্ঠ	ōṣṭha
নগর	nôgôr
ইচ্ছা হওয়া	iccha hôoẇa
দুগ্ধ	dugdha
দুধ	dudha
লেনিন	lenin
বৃষ্টি	brishţi
কামসূত্র	kamôsutrô
কারাওকে	kara'oke
কেব্লকার	kēblakāra
সাত	shat
সমরতি	sômôrôti
গে	ge
বায়ু	bayu
পাপ	pap
দুগ্ধ	dudh
চর্বি	côrbi
মিত্র	mitra
পাক	pāka
নটরাজ	naṭrāj
প্রাচীন রোম	pracin rom
ধোঁয়া	dhōm̐ẏā
নয	nay
সিন্ধু	shindhu
জাহান্নাম	jahannam
এক	ek
বিন্দু	bindu
ভক্তি	bhǒkti
অভিধান	ôbhidhan
গাঁজা	gañja
পশ্চিমবঙ্গ	Pôshcimbônggô
আদিগেয়া	adigeya
দক্ষিণ ওসেটিয়া	dôkhin oseţiẏa
ইয়েকাতেরিনবুর্গ	iẏēkātērinaburg
গুড়	guŗ
চাটা	caţa
চাটা	caţa
মরণ	môrôņ
শিয়াল	shiẏal
অনুস্বর	ônusshôr
মুখ	mukh
শুভ জন্মদিন	śubhô jônmôdin
আবলুস	āblus
ফেইসবুক	feisbuk
ফেসবুক	fesbuk
খাজা	Khājā
খোজা	khōjā
গাজা ভূখণ্ড	gaja bhukhônḑ
দুধ	dudh
মুম্বই	Mumbôi
হাত পা	hat pa
হাত-পা	hat-pa
সোচি	soci
আসসলামু আলাইকুম	as-salamu alaikum
শঙ্খচূড়	shôngkhocuŗ
বিড়াল	biŗal
ছদ্মনাম	chôddônam
ডাকনাম	ḑaknam
নামক	namôk
নামজাদা	namjada
নামহীন	namhin
কর্ণ	kôrnô
মৌখিক	moukhik
কেউটে সাপ	keuţe shap
গুই সাপ	gui shap
সাপুড়ে	shapuŗe
সামুদ্রিক সাপ	shamudrik shap
অজগর	ôjôgôr
গোখরা	gokhra
গোখরো	gokhro
ব্ল্যাক মাম্বা	blêk mamba
সর্পদংশন	shôrpôdôngshôn
শঙ্খচূড়	shôngkhôcuŗ
আফ্রিকান হাতি	aphrikan hati
এশীয় হাতি	eshiẹ hati
বৃক্ষ	brikkhô
উদ্ভিদ	udbhid
কমল	kômôl
পঙ্কজ	pôngkôj
কুমুদ	kumud
শতদল	shôtôdôl
সরসিজ	shôrôshijô
মৃণাল	mrinal
পদ্মিনী	pôddini
পদ্মনাভ	pôddônabh
পদ্মফুল	pôddôphul
পদ্মরাগ	pôddôrag
পদ্মলোচন	pôddôlocôn
ফল	phôl
ডিকশনারি	ḑikshônari
ডিকশনারী	ḑikshônari
আভিধানিক	abhidhanik
সামুদ্রিক	shamudrik
দেখানো	dekhano
তর্জমা	tôrjôma
অনুবাদ করা	ônubad kôra
অনুবাদক	ônubadôk
আপনি বাংলা বলতে পারেন?	āpni bānlā balatē pārēn?
মৈথুন	moithun
রক্ত	rôktô
সঙ্গীত	sônggit
লিঙ্গ	linggô
ধর্মীয়	dhôrmiẹ
ধার্মিক	dharmik
দলিত	dôlit
ভাষিক	bhashik
ভাষাসমূহ	bhashashômuh???
মাতৃভাষা	matribhasha
বাঘ	bagh
আমি ইংরেজি বলতে পারি না	ami inreji bolte pari na
আমার ক্ষুধা লাগছে	amar khuda lagchhe
আমাকে একা থাকতে দাও	amake eka thakte dao
শাক্তধর্ম	shaktôdhôrmô
গ্রেইট ব্রিটেনের যুক্তরাজ্য	grē'iṭ briṭēnēr yuktarājya
সংস্কৃত	Sôngskrit
ইমেইল	ime'il
ই-মেইল	i-me'il
ইমেইল	ime'il
ই-মেইল	i-me'il
অন্ধ্রপ্রদেশ	Ôndhrôprôdesh
...ইংরেজিয় আপনি কীভাবে বলবেন?	...ingrejiye apni kibhabe bolben?
...ইংরেজিয় তুমি কীভাবে বলবে?	...ingrejiye tumi kibhabe bolbe?
দোজখ	dōjakha
তরমুজ	tôrômuj
অকাল বীর্যপাত	ôkal birjopat
নিষ্ঠুরতা	nishţhurta
গম্বুজ	gambuja
ভুবনেশ্বর	bhubanēśbar
মরা	môra
মৃত	mritô
উত্তরাখণ্ড	uttarākhaṇḍ
হাওড়া	haoṛa
রংধনু	rông-dhônu
কাসাব্লাংকা	kāsāblāṅkā
আলতাই	alta'i
এলাহাবাদ	elahabad
যে কি?	yē ki
কনলী	Kanlī
প্রজাপতি	projapoti, prajapati
প্রজাপতি	projapoti, prajapati
আমি বাংলা বলতে পারি না	āmi bāṁlā boltē pāri nā
সার্কোজি	sārkōji
বেরলুসকোনি	bērluskōni
আমার অনুবাদক লাগবে	amar ônubadôk lagbe
আমি ইংরেজি	āmi inrējī
ঢাকা জেলা	Ḑhaka jela
ঢাকা বিভাগ	Ḑhaka bibhag
ইংরেজি ভাষা	Ingreji bhasha
আমার ডাক্তার লাগবে	amar ḑaktar lagbe
আমার সাহায্য লাগবে	amar shahajyô lagbe
আপনি কি বিবাহিত?	apni ki bibahitô?
আমার পানি লাগবে	amar pani lagbe
আমার ডিকশনারী লাগবে	amar ḍikshônari lagbe
আমার খাবার চাই	amar khabar cai
চেঙ্গিজ খান	cēṅgij-khān
বড়ো	bôŗo
ছোট	choţô
অনিবার্য	ônibarjô
লিঙ্গ	linggô
শিশ্ন	shishnô
পুরুষাঙ্গ	purushanggô
পেনিস	penis
নুনু	nunu
বাড়া	baŗa
ডান্ডা	ḑanḑa
খাড়া ধন	khaŗa dhôn
খাড়াধন	khaŗadhôn
আমি জানি	ami jani
আমি ধার্মিক নই	ami dharmik nôi
আমার পানীয় লাগবে	amar paniya lagbe
আমার পানীয় লাগবে	amar paniya lagbe
আমি ইংরেজি বলতে পারি না	āmi inrēji boltē pāri nā
আপনি কি ধার্মিক?	apni ki dharmik?
তুমি কি ধার্মিক?	tumi ki dharmik?
আপনারা কি ধার্মিক?	apnara ki dharmik?
তোমরা কি ধার্মিক?	tomra ki dharmik?
আমি গে	ami ge
বু পূর্ণিমা	Buddho Purnima
বুদ্ধ জয়ন্তী	Buddho Joyonti
হিন্দি ভাষা	hindi bhasha
ইসলামী	islami
সৌর	sourô
চন্দ্র	côndrô
চান্দ্র	candrô
উর্দু ভাষা	urdu bhasha
বন্ধ করা	bôndhô kôra
করানো	kôrano
জানানো	janano
আমি জানি	ami jani
আমি জানি না	ami jani na
আমি জানতে চাই	ami jante cai
এখানে ইংরেজি বলতে পারেন এমন কেউ আছেন?	ekhane ingreji bolte paren emôn keu achen?
অধার্মিক	ôdharmik
ধর্মীয়	dhôrmiẹ
ভালোবাসা	bhalobasha
ঘৃণা করা	ghrina kôra
প্রশ্ন করা	prôshnô kôra
সংগীত	sônggit
সাঙ্গীতিক	sanggitik
সাংগীতিক	sanggitik
সুরেলা	surela
সঙ্গীত	sônggit
চোরাবালি	corabali
ভালো	bhalo
চাওয়ানো	caoẇano
বই	bôi
গ্রন্থ	grônthô
পুটকি	puţki
চুম্বন করা	cumbôn kôra
-চুম্বী	cumbi
পারিবারিক	paribarik
গান	gan
নৃত্য	nrittô
নাচা	naca
অগ্নি	ôgni
আগ্নেয়	agneẏ
আগ্নেয়গিরি	agneẏôgiri
আগুন	agun
আগ্নেয়	agneẏ
আগ্নেয়গিরি	agneẏôgiri
আর্দ্রতা	ardrôta
শক্ত	shôktô
সহজ	sôhôj
নরম	nôrôm
আর্দ্র	ardrô
নরম	nôrôm
আর্দ্র	ardrô
আর্দ্র	ardrô
শক্ত	shôktô
কঠিন	kôṭhin
ফাল্গুন	Phalgun
চৈত্র	Coitrô
বৈশাখ	Boishakh
জ্যৈষ্ঠ	Joishţho
ভাদ্র	Bhadro
আশ্বিন	Asshin
কার্তিক	Kartik
অগ্রহায়ণ	Ôgrôhaẏôn
পৌষ	Poush
মাঘ	Magh
শীতল	shitôl
উদাহরণমূলক	udahôrônmulôk
হস্ত	hôstô
হাত পা	hat pa
হাত-পা	hat-pa
লিঙ্গ	linggô
পুরুষাঙ্গ	purushanggô
পেনিস	penis
ধন	dhôn
নুনু	nunu
বাড়া	baŗa
ডান্ডা	ḑanḑa
লিঙ্গ	linggô
শিশ্ন	shishnô
পেনিস	penis
ধন	dhôn
নুনু	nunu
বাড়া	baŗa
ডান্ডা	ḑanḑa
শিশ্ন	shishnô
পুরুষাঙ্গ	purushanggô
পেনিস	penis
ধন	dhôn
নুনু	nunu
বাড়া	baŗa
ডান্ডা	ḑanḑa
ভোদা	bhoda
বীচি	bici
যুবতী	jubôti
পুরোনো	purono
নারী	nari
লৈঙ্গিক	loinggik
যৌন প্রবৃত্তি	joun prôbritti
যৌনতা	jounta
আর	ar
কিংবা	kingba
বা	ba
লেখা	lekha
শেখানো	shekhano
শিখানো	shikhano
শিক্ষা	shikkha
শীত	shit
পুটকিচুদা	puţkicuda
পুটকিচোদা	puţkicoda
পাছা	pacha
পুটকিচোদা	putkicoda
পুটকিচুদা	putkicuda
চুদা	cuda
চোদাচুদি	codacudi
চোদা	coda
ছেলেমানুষ	chelemanush
ইহুদি ধর্ম	ihudi dhôrmô
রক্ত ঝরা	rôktô jhôra
রক্ত পড়া	rôktô pôŗa
রক্তকমল	rôktôkômôl
রক্তকাঞ্চন	rôktôkancôn
রক্তক্ষয়	rôktôkkhôẏ
রক্তগঙ্গা	rôktôgôngga
রক্তচক্ষু	rôktôcôkkhu
রক্তচাপ	rôktôcap
রক্তপাত	rôktôpat
রক্তপাতহীন	rôktôpat-hin
রক্তবর্ণ	rôktôbôrnô
রক্তহীন	rôktôhin
রক্তাক্ত	rôktaktô
মূত্র	mutrô
মাল	mal
বীর্যপাত	birjôpat
বীর্যস্খলন	birjôskhôlôn
শুক্রাণু	shukranu
ডিল্ডো	ḑilḑo
বাঘিনি	baghini
মরা	môra
মৃত্যু	mrityu
মৃত	mritô
মৃত্যু	mrityu
তর্জমা করা	tôrjôma kôra
অনুবাদ	ônubad
তর্জমা করা	tôrjôma kôra
অনুবাদ করা	ônubad kôra
তুমি	tumi
আচরণ করা	acôrôn kôra
আচরণবিধি	acôrônbidhi
প্রবণ	prôbôn
বড়	bôṛô
নেওয়া	neoẇa
গাঞ্জা	ganja
গঞ্জিকা	ganjika
সিদ্ধি	shiddhi
গাঁজাখোর	gãjakhor
গাঞ্জাখোর	ganjakhor
বন্ধু	bôndhu
মিত্র	mitrô
বান্ধবী	bandhôbi
বন্ধুত্ব	bôndhuttô
বন্ধুত্বপূর্ণ	bôndhuttôpurnô
বন্ধুভাবাপন্ন	bôndhubhabapônnô
বন্ধুসুলভ	bôndhushulôbh
বন্ধুহীন	bôndhuhin
বন্ধুত্বপূর্ণ	bôndhuttôpurnô
বন্ধুভাবাপন্ন	bôndhubhabapônnô
আল কোরআন	al kor-an
আল কুরআন	al kur-an
কুরান	kuran
কোরআন	kor-an
ভাইয়া	bhaiẏa
আলাপ করা	alap kôra
ভাল্লুক	bhalluk
স্লথ ভাল্লুক	slôthô bhalluk
স্লথ ভালুক	slôthô bhaluk
বাদামি ভাল্লুক	badami bhalluk
বাদামি ভালুক	badami bhaluk
এশিয়ান কালো ভাল্লুক	eshiyan kalo bhalluk
এশিয়ান কালো ভালুক	eshiyan kalo bhaluk
মেরু ভাল্লুক	meru bhalluk
মেরু ভালুক	meru bhaluk
ভালুক	bhaluk
স্লথ ভাল্লুক	slôthô bhalluk
স্লথ ভালুক	slôthô bhaluk
বাদামি ভাল্লুক	badami bhalluk
বাদামি ভালুক	badami bhaluk
এশিয়ান কালো ভাল্লুক	eshiyan kalo bhalluk
এশিয়ান কালো ভালুক	eshiyan kalo bhaluk
মেরু ভাল্লুক	meru bhalluk
মেরু ভালুক	meru bhaluk
স্লথ ভালুক	slôthô bhaluk
বাদামি ভালুক	badami bhaluk
এশিয়ান কালো ভালুক	eshiyan kalo bhaluk
মেরু ভালুক	meru bhaluk
স্লথ ভাল্লুক	slôthô bhalluk
বাদামি ভাল্লুক	badami bhalluk
এশিয়ান কালো ভাল্লুক	eshiyan kalo bhalluk
মেরু ভাল্লুক	meru bhalluk
তোমার নাম কি	tomar nam ki?
আপনার নাম কি	apnar nam ki?
দ্রুত	drutô
ধীর	dhirô
ডিকশনারি	ḑikshônari
অভিধান	ôbhidhan
আমি জানি	ami jani
আমি জানি না	ami jani na
আমি তোমাকে ভালবাসি	ami tomake bhalôbashi
ভালবাসা	bhalôbasha
তুমি কি ধার্মিক?	tumi ki dharmik?
আপনারা কি ধার্মিক?	apnara ki dharmik?
তোমরা কি ধার্মিক?	tomra ki dharmik?
আপনি কি ধার্মিক?	apni ki dharmik?
আপনারা কি ধার্মিক?	apnara ki dharmik?
তোমরা কি ধার্মিক?	tomra ki dharmik?
আপনি কি ধার্মিক?	apni ki dharmik?
তুমি কি ধার্মিক?	tumi ki dharmik?
তোমরা কি ধার্মিক?	tomra ki dharmik?
আপনি কি ধার্মিক?	apni ki dharmik?
তুমি কি ধার্মিক?	tumi ki dharmik?
আপনারা কি ধার্মিক?	apnara ki dharmik?
আপনার সাহায্য লাগবে?	apnar shahajjo lagbe?
তোমার সাহায্য লাগবে?	tomar shahajjo lagbe?
বুঝি না	bujhi na
আমি বুঝি না	ami bujhi na
আমি বুঝি না	ami bujhi na
পরে	pôre
নিচে	nice
জন্যে	jônne
জন্যে	jônne
জন্য	jônnô
উপরে	upôre
পর	pôr
আগে	age
এরপরে	erpôre
এর পরে	er pôre
তারপরে	tarpôre
তার পরে	tar pôre
সামনে	shamne
পিছনে	pichône
ভেতরে	bhetôre
ভিতরে	bhitôre
বাইরে	baire
প্রাণী	prani
পশু	pôshu
দেহ	dehô
লাগা	laga
ব্যক্তিগত	bêktigôtô
ব্যক্তিত্ব	bêktittô
দেশি	deshi
দেশী	deshi
দেশীয়	deshiẹ
দেশিয়	deshiẹ
দেশপ্রেমিক	deshpremik
দেশবন্ধু	deshbôndhu
দেশময়	deshmôẏ
দৈশিক	doishik
বাংলাদেশ	Bangladesh
পর্বতমালা	pôrbôtmala
বেগুনি	beguni
হারানো	harano
দেওয়া	deoẇa
অগাষ্ট	Ôgôsţ
প্রাসঙ্গিকতা	prasôņgikta
প্রাসঙ্গিকতা	prasôņgikta
পর্ন	pôrn, pôrnô
পর্নো	pôrno
পর্নোগ্রাফিক	pôrnographik
মনে রাখা	mône rakha
ভুলে যাওয়া	bhule jaoa
পর্নোগ্রাফি	pôrnographi
সেক্সী	seksi
সেক্সি	seksi
হাত মারা	hat mara
স্বকাম	sshôkam
স্বমেহন	sshômehôn
আত্মমৈথুন	atmômoithun
আত্ম মৈথুন	atmô moithun
হস্তমৈথুন করা	hôstômoithun kôra
প্রোস্টেট গ্রন্থি	prosţeţ grônthi
প্রোস্টেট	prosţeţ
হৃদয়	hridôy
হার্ট	harţ
ডিলডো	ḑilḑo
হস্তমৈথুন	hôstômoithun
মাল ফেলা	mal phela
তফাত	tôfat
পার্থক্য	parthôkkô
সব জায়গা	shôb jaẹga
পেশি	peshi
পেশীবহুল	peshibôhul
পেশিবহুল	peshibôhul
পেশী	peshi
পেশিবহুল	peshibôhul
পেশীবহুল	peshibôhul
পেশীবহুল	peshibôhul
পেশিবহুল	peshibôhul
বেড়াল	beŗal
বাদামী	badami
জানি না	jani na
জানি না	jani na
আমি জানতে চাই	ami jante cai
আমি জানি না	ami jani na
আমি জানি না	ami jani na
আমি জানতে চাই	ami jante cai
বীর্য	birjô
মাল ফেলা	mal phela
বীর্যস্খলন	birjôskhôlôn
বীর্যপাত	birjôpat
পাওয়ানো	paoẇano
বেরোনো	berono
ঢোকানো	ḑhokano
ঢুকানো	ḑhukano
পুরোনো	purono
নতুনত্ব	nôtunôttô
যুবক	jubôk
নতুন	nôtun
যুবক	jubôk
পুরোনো	purono
ঢুকানো	ḑhukano
ঢোকানো	ḑhokano
ক্ষমা করা	khôma kôra
ক্ষমা করবেন	khôma kôrben
ক্ষমাহীন	khômahin
যোনি	joni
বাংলা	bangla
বাংলা	Bangla
মৌল	moul
মৌলিক	moulik
বিভিন্নতা	bibhinnôta
খবর	khôbôr
রামাদান	ramadan
-ঈ	-i
ফৌজি	phouji
সংবাদ	shôngbad
ইতিমধ্যে	itimôddhe
গণপ্রজাতন্ত্রী বাংলাদেশ	Gônoprojatontri Bangladesh
বাংলাদেশ	Bangladesh
রংপুর বিভাগ	Rôngpur bibhag
রাজশাহী বিভাগ	Rajshahi bibhag
বরিশাল বিভাগ	Bôrishal bibhag
ঢাকা বিভাগ	Ḑhaka bibhag
খুলনা বিভাগ	Khulna bibhag
চট্টগ্রাম বিভাগ	Côţţôgram bibhag
সিলেট বিভাগ	Sileţ bibhag
উপজেলা	upôjela
ভরানো	bhôrano
পদ্মা নদী	Pôdda nôri
জাফলং	Japhlông
বাঙালি নদী	Bangali nôdi
লেখা	lekha
লেখক	lekhôk
লিখিত	likhitô
পড়া	pôŗa
ঘামা	ghama
ঘামানো	ghamano
ঘাম	gham
হৃৎপিন্ড	hritpinḑô
হৃদয়	hridôy
হৃৎপিন্ড	hritpinḑô
হার্ট	harţ
দাঁড়ানো	dãŗano
হাসানো	hashano
আল্লাহু আকবার	Allahu akbar
আল্লাহু আকবর	Allahu akbôr
স্বপ্ন দেখা	shôpnô dekha
স্বপ্নচারি	shôpnôcari
স্বপ্নচারিতা	shôpnôcarita
স্বপ্নহীন	shôpnôhin
স্বাপ্নিক	shapnik
পশম	pôshôm
বাল	bal
যত	jôtô
বেরিয়ে আসা	beriẏe asha
যাওয়া	jaoẇa
আন্তর্জাল	antôrjal
ল্যাপটপ কম্পিউটার	lêpţôp kômpiuţar
কম্পিউটিং	kômpiuţing
কম্পিউটার	kômpiuţar
সফটওয়্যার	sôfţ-owar
হার্ডওয়্যার	harḑ-owar
বৈজ্ঞানিক	boigganik
উপসাগর	upôshagôr
বিদেশি	bideshi
চলনবিল	Côlônbil
উপজেলা	upôjela
সৈয়দপুর	Soiẏedpur
আগ্রাবাদ	Agrabad
চট্টগ্রাম	Côţţôgram
চট্টগ্রাম বিভাগ	Côţţôgram bibhag
চট্টগ্রাম জেলা	Côţţôgram jela
বীর্যপাত	birjôpat
বীর্যস্খলন	birjôskhôlôn
হাত মারা	hat mara
চাওয়া	chaoẇa
থাকানো	thakano
পশ্চিমবঙ্গ	Pôshcimbônggô
পশ্চিম বঙ্গ	Pôshcim Bônggô
পশ্চিমবাংলা	Pôshcimbangla
পশ্চিম বাংলা	Pôshcim Bangla
পূর্ববাংলা	Purbôbangla
পূর্ব বাংলা	Purbô Bangla
একটা কিছু	ekţa kichu
উইকিঅভিধান	uikiabhidhān
ঝুলানো	jhulano
গাছ	gach
পাকিস্তান	Pakistan
ইসলামি	islami
ইসলামী	islami
সময়োপযোগী	shômôẏopôjogi
সময়কাল	shômôẏkal
কি না	ki na
গণতান্ত্রিক সমাজতান্ত্রিক প্রজাতন্ত্রী শ্রীলঙ্কা	gaṇatāntrika samājatāntrika prajātantrī śrīlaṅkā
শ্রীলঙ্কা	Shrilôngka
গণতান্ত্রিক	gônôtantrik
সমাজতান্ত্রিক	shômajtantrik
উগ্রতা	ugrôta
গীটার	giţar
ইলেকট্রিক গিটার	ilekţrik giţar
ইলেকট্রিক গীটার	ilekţrik giţar
বেস গিটার	bes giţar
বেস গীটার	bes giţar
বিদেশী	bideshi
বিদেশি	bideshi
বিদেশী	bideshi
বৈদেশিক	boideshik
ধার্মিক	dharmik
ভাষাবৈজ্ঞানিক	bhashaboigganik
ধোয়া	dhoa
ধোওয়া	dhoa
অসভ্য	ôshôbbhô
ভারতীয় ময়ূর	Bhartiẹ môyur
ময়ূরী	môyuri
পেখম	pekhôm
ভারত	Bharôt
ময়ূর	môyur
ভাঙানো	bhangano
মুরগি	murgi
মোরগ	morôg
গুইসাপ	guishap
গোসাপ	goshap
মাকড়শা	makôŗsha
মাকড়সার জাল	makôŗshar jal
মাকড়শার জাল	makôŗshar jal
মাকড়সা	makôŗsha
মাকড়শার জাল	makôŗshar jal
মাকড়সার জাল	makôŗshar jal
হাঙ্গর	hanggôr
হাঙর	hangôr
সাপ	shap
সাপুড়ে	shapuŗe
বাতাস	batash
হাওয়া	haoẇa
বায়ু	baẏu
হাওয়া	haoẇa
বাতাস	batash
বায়ু	baẏu
বিশ্লেষণ করা	bisleshôn kôra
ফটোগ্রাফ	fôţograf
ফটোগ্রাফি	fôţografi
ফটোগ্রাফী	fôţografi
ফটো	fôţo
ফটোগ্রাফি	fôţografi
ফটোগ্রাফী	fôţografi
ফটোগ্রাফী	fôţografi
ফটো	fôţo
ফটোগ্রাফ	fôţograf
ফটোগ্রাফি	fôţografi
ফটো	fôţo
ফটোগ্রাফ	fôţograf
বাদামি	badami
কেনানো	kenano
বেচা	beca
বেচানো	becano
কেনা	kena
ঝরানো	jhôrano
গর্ভবতী	gôrbhôbôti
গর্ভধারণ	gôrbhôdharôn
গর্ভধারণ	gôrbhôdharôn
বিশেষ করা	bishesh kôra
সাংস্কৃতিক	sangskritik
মেলানো	melano
ভৌগলিক	bhougôlik
ভৌগোলিক	bhougolik
আজকার	ajkar
আজকের	ajker
আজকাল	ajkal
আজকে	ajke
গতকাল	gôtôkal
আগামিকাল	agamikal
ধান	dhan
মধ্যমস্তিষ্ক	môddhômôstishkô
মস্তিষ্কহীন	môstishkôhin
ফুলানো	phulano
ফোলানো	pholano
ডার্ক চকলেট	ḑark côkôleţ
প্রমাণ করা	prôman kôra
প্রমাণিত	prômanit
পতাকা	pôtaka
ফ্ল্যাগ	flêg
অপরাধ করা	ôpôradh kôra
অপরাধমূলক	ôpôradhmulôk
অথবা	ôthôba
বা	ba
অথবা	ôthôba
কিংবা	kingba
সতর্ক থাকা	sôtôrkô thaka
সতর্ক করা	sôtôrkô kôra
সতর্কীকরণ	sôtôrkikôrôn
দুর্গতি	durgôti
উচ্চ মাধ্যমিক শিক্ষা	uccô maddhômik shikkha
উচ্চশিক্ষা	uccôshikkha
শিক্ষা করা	shikkha kôra
শিক্ষা দেওয়া	shikkha deoa
শিক্ষাপ্রতিষ্ঠান	shikkhaprôtishtan
শিক্ষাপ্রাপ্ত	shikkhapraptô
শিক্ষামূলক	shikkhamulôk
শেখা	shekha
বৃষ্টি পড়া	brishţi pôŗa
বৃষ্টি হওয়া	brishţi hôoẇa
বৃষ্টিপাত	brishţipat
অভিযোগ করা	ôbhijog kôra
পরীক্ষা করা	pôrikkha kôra
শোনা	shona
শ্রবণ	srôbôn
শ্রবণ করা	srôbôn kôra
ধার্মিক	dharmik
সামাজিক	samajik
নীরবে	nirôbe
নীরবতা	nirôbôta
ছোঁয়া	chõa
লাগানো	lagano
এর পর	er pôr
এরপরে	erpôre
এর পরে	er pôre
তারপর	tarpôr
তার পর	tar pôr
তারপরে	tarpôre
তার পরে	tar pôre
এগনো	egôno
ক্যাব	kêb
পশ্চিম বঙ্গ	Pôshcim Bônggô
ভারতীয় বঙ্গ	Bhārôtiô Bônggô
বঙ্গদেশ	Bônggôdesh
বাঙালী	Bangali
বাঙালি	Bangali
বাংলা	Bangla
বাংলাদেশ	Bangladesh
বাংলাদেশী	Bangladeshi
বাংলাদেশি	Bangladeshi
গঙ্গা	Gôngga
নৈসর্গিক	noishôrgik
ওখান	okhan
সেখান	shekhan
পেশাদার	peshadar
গণিকাবৃত্তি	gônikabritti
ওভাবে	obhabe
কিভাবে	kibhabe
কীভাবে	kibhabe
কীভাবে	kibhabe
এভাবে	ebhabe
কিভাবে	kibhabe
এভাবে	ebhabe
উল্কি আঁকা	ulki ãka
উল্কিকরণ	ulkikôrôn
খাড়া ধন	khaŗa dhôn
খাড়াধন	khaŗadhôn
নির্বাচন করা	nirbacôn kôra
কমিশনার	kômishônar
সাহায্য করা	shahajjô kôra
সাহায্যকারী	shahajjôkari
ব্যাঙ্ক	bêngk
ব্যাংক	bêngk
সিলেটি	Sileţi
সিলেটি ভাষা	Sileţi bhasha
খাড়াধন	khaŗadhôn
খাড়া ধন	khaŗa dhôn
ধাক্কা দেওয়া	dhakka deoa
অণ্ডকোষ	ônḑôkosh
শুক্রাশয়	shukrashôy
অন্ডকোষ	ônḑôkosh
শুক্রাশয়	shukrashôy
আঞ্চলিক	ancôlik
আঞ্চলিক	ancôlikta
আঞ্চলিকতা	ancôlikta
অকারণ	ôkarôn
কারণে	karône
ঢোকা	ḑhoka
মাখানো	makhano
শোয়ানো	soẇano
শুয়ে পড়া	suẏe pôŗa
খোলা	khola
হাত পা	hat pa
হাত-পা	hat-pa
হড়কানি	haŗkani
শিখানো	shikhano
নওয়ানো	naoẇano
খানকী	khanki
বৃষ্টি পড়া	pôŗa
মুসলমান	musôlman
মুসলিম	muslim
লড়াই	lôŗai
লড়াকু	lôŗaku
লড়ানো	lôŗano
উভকামিতা	ubhôkamita
সমকামিতা	sômôkamita
ইচ্ছা হওয়া	iccha hôoẇa
ইচ্ছাকৃত	icchakritô
আষাঢ়	Ashaŗh
শ্রাবণ	Srabon
নাঙ্গা	nangga
নগ্নতা	nôgnôta
নগ্ন	nôgnô
বিবাদ করা	bibad kôra
বিবাদি	bibadi
বিবাদী	bibadi
মনযোগ	mônôjog
মনোযোগ দেওয়া	mônojog deoẇa
মনোযোগী	mônojogi
অনুরোধ করা	ônurodh kôra
অনুরোধে	ônurodhe
কাল্পনিক	kalpônik
বসা	bôsha
অপেক্ষা করা	ôpekha kôra
অপেক্ষাকৃত	ôpekhakritô
তুমি কেমন আছো?	tumi kêmôn acho?
তুই কেমন আছিস?	tui kêmôn achish?
আপনি কেমন আছেন?	apni kêmôn achen?
তুই কেমন আছিস?	tui kêmôn achish?
আপনি কেমন আছেন?	apni kêmôn achen?
তুমি কেমন আছো?	tumi kêmôn acho?
ঢেউ	ḑheu
তরঙ্গ	tôrônggô
পদার্থবিজ্ঞান	pôdarthôbiggan
চন্দ্রগ্রহণ	côndrôgrôhôn
সূর্যগ্রহণ	surjôgrôhôn
জীববৈজ্ঞানিক	pôdarthôboigganik
নম্বর	nômbôr
পছন্দ করা	pôchôndô kôra
আলোচনা করা	alocôna kôra
আলোচনা হওয়া	alocôna hôoẇa
যৌনসঙ্গম	jounsônggôm
হস্তমৈথুন	hôstômoithun
নিষিদ্ধ করা	nishiddhô kôra
জংলি	jôngli
জঙ্গল	jônggôl
জঙ্গল	jônggôl
বাঁদর	bãdôr
বানর	banôr
জানোয়ার	janoẇar
প্রাণী	prani
ইগল	igôl
কেউ	keu
একটা কেউ	ekţa keu
কেউ না	keu na
সবাই	shôbai
কেউ একটা	keu ekţa
একটা কেউ	ekţa keu
কেউ না	keu na
সবাই	shôbai
কেউ	keu
সবাই	shôbai
আমি জানি না	ami jani na
আমি জানি না	ami jani na
আমি জানতে চাই	ami jante cai
রেড ওয়াইন	reḑ oẇain
ল্যাপটপ কম্পিউটার	lêpţôp kômpiuţar
কিলোবাইট	kilobaiţ
মেগাবাইট	megabaiţ
গিগাবাইট	gigabaiţ
টেরাবাইট	ţerabaiţ
প্রবঞ্চনামূলক	prôbôncônamulôk
বেশি	beshi
আলোর দ্রুতি	alor druti
বেগুনী	beguni
বেগুনী	beguni
কাল	kalô
মধ্যম পুরুষ	môddhôm purush
প্রথম পুরুষ	prôthôm purush
উত্তম পুরুষ	uttôm purush
প্রথম পুরুষ	prôthôm purush
উত্তম পুরুষ	uttôm purush
মধ্যম পুরুষ	môddhôm purush
কিছু না	kichu na
কিছু একটা	kichu ekţa
একটা কিছু	ekţa kichu
কিছুক্ষন	kichukkhôn
কিছুতে	kichute
কিছুতেই না	kichutei na
কিছু কিছু	kichu kichu
কিছু না কিছু	kichu na kichu
কিছু একটা	kichu ekţa
কিছুতেই না	kichutei na
কিছু না কিছু	kichu na kichu
ঈদ মোবারাক	id mobarak
ঈদ মোবারক	id mobarôk
ঈদ মুবারক	id mubarôk
ঈদ মোবারাক	id mobarak
ঈদ মুবারাক	id mubarak
ঈদ মুবারক	id mubarôk
ঈদ মোবারাক	id mobarak
ঈদ মোবারক	id mobarôk
ঈদ মোবারাক	id mobarak
ঈদ মোবারক	id mobarôk
ঈদ মুবারাক	id mubarak
ঈদ মোবারক	id mobarôk
ঈদ মুবারাক	id mubarak
ঈদ মোবারক	id mobarôk
ঈদ মুবারাক	id mubarak
ঈদ মুবারক	id mubarôk
শান্ত করা	shantô kôra
শান্তি	shanti
বিশ্রি	bisri
বর্ণনা করা	bôrnôna kôra
বর্ণনাতীত	bôrnônatitô
রাজস্থানি	Rajôsthani
রাজস্থানী	Rajôsthani
অ্যালিগেটর	êligeţôr
ওখানে	okhane
সেখানে	shekhane
এখান	ekhan
সেখান	shekhan
এখান	ekhan
ওখান	okhan
এখানে	ekhane
সেখানে	shekhane
এখানে	ekhane
ওখানে	okhane
জাগানো	jagano
দৈহিক	doihik
কোথায়	kothaẏ
পরিষ্কার	pôrishkar
পরিস্কার	pôrishkar
সাফ করা	saph kôra
পরে	pôre
আগে	age
এরপর	erpôr
এর পর	er pôr
তারপর	tarpôr
তার পর	tar pôr
বন্ধ করা	bôndhô kôra
বীর্য	birjô
বাংলাদেশি	Bangladeshi
বাংলাদেশী	Bangladeshi
হাগু	hagu
হাগা	haga
মতো	môto
চালা	cala
চালানো	calano
তার পর	tar pôr
তারপরে	tarpôre
তার পরে	tar pôre
এরপর	erpôr
এর পর	er pôr
এরপরে	erpôre
এর পরে	er pôre
এরপর	erpôr
এরপরে	erpôre
এর পরে	er pôre
তারপর	tarpôr
তার পর	tar pôr
তারপরে	tarpôre
তার পরে	tar pôre
তারপর	tarpôr
তারপরে	tarpôre
তার পরে	tar pôre
এরপর	erpôr
এর পর	er pôr
এরপরে	erpôre
এর পরে	er pôre
এরপর	erpôr
এর পর	er pôr
এরপরে	erpôre
তারপর	tarpôr
তার পর	tar pôr
তারপরে	tarpôre
তার পরে	tar pôre
এরপর	erpôr
এর পর	er pôr
এর পরে	er pôre
তারপর	tarpôr
তার পর	tar pôr
তারপরে	tarpôre
তার পরে	tar pôre
তারপর	tarpôr
তার পর	tar pôr
তারপরে	tarpôre
এরপর	erpôr
এর পর	er pôr
এরপরে	erpôre
এর পরে	er pôre
তারপর	tarpôr
তার পর	tar pôr
তার পরে	tar pôre
এরপর	erpôr
এর পর	er pôr
এরপরে	erpôre
এর পরে	er pôre
সহস্র	shôhôsrô
মত	môtô
ফটক	phôṭôkô
ধোঁয়াটে	dhõẇaţe
জ্বালাতন করা	jalatôn kôra
বেদনাদায়ক	bedônadaẏôk
সিন্ধুঘোটক	shindhughoţôk
চোখ	cokh
চোখ	cokh
অন্ধকার	ôndhôkar
অন্ধকূপ	ôndhôkup
অন্ধত্ব	ôndhôttô
অন্ধপ্রায়	ôndhôpraẏ
অন্ধবিন্দু	ôndhôbindu
অন্ধবিশ্বাস	ôndhôbishash
অন্ধভাবে	ôndhôbhabe
ডিকশনারী	ḑikshônari
অভিধান	ôbhidhan
লোকাল এরিয়া নেটওয়ার্ক	lokal eriẏa neţoẇark
মোটাসোটা	moţasoţa
মূত্রনালী	mutrônali
মূত্রনালি	mutrônali
মূত্রনালী	mutrônali
মূত্রনালি	mutrônali
প্রস্রাব	prôsrab
ভিয়েতনামীয়	Bhiẏetnamiẹ
ভিয়েতনামীয় ভাষা	Bhiẏetnamiẹ bhasha
মধ্যে	môddhe
মধ্যক	môddhôk
মধ্যপ্রাচ্য	môddhôpracô
মধ্যরাত	môddhôrat
সৃষ্টিকর্তা	srishţikôrta
রক্তপাতহীন	rôktôpat-hin
রক্তপাতহীন	rôktôpat-hin
রক্তহীন	rôktôhin
লিথুয়ানীয়	Lituẇaniẹ
লিথুয়ানীয় ভাষা	Lituẇaniẹ bhasha
প্রকারণ	prôkarôn
মূর্খতা	murkhôta
ব্যবহার করা	bêbôhar kôra
ব্যবহার হওয়া	bêbôhar hôoẇa
ব্যবহারকারী	bêbôharkari
ব্যবহার্য	bêbôharjô
ব্যবহারযোগ্য	bêbôharjoggô
যা কিছু	ja kichu
যা হোক	ja hok
-টা	-ţa
-রা	-ra
-এরা	-era
-গুলা	-gula
-গুলো	-gulo
রাষ্ট্রীয়	rashţriẹ
রাষ্ট্রনায়ক	rashţrônaẏôk
রাষ্ট্রপতি	rashţrôpôti
রাষ্ট্রপ্রধান	rashţrôprôdhan
রাষ্ট্রভাষা	rashţrôbhasha
খ্রিস্টান	khrisţan
প্রেম করা	prem kôra
প্রেমিক	premik
প্রেমহীন	premhin
ভালবাসা	bhalôbasha
জিব	jib
জিভ	jibh
জিভ	jibh
জিহ্বা	jihba
জিব	jib
জিহ্বা	jihba
মকান	môkan
যুক্ত করা	juktô kôra
যুক্তরাজ্য	Juktôrajjô
মার্কিন যুক্তরাষ্ট্র	Markin Juktôrashţrô
পুঞ্জীভূত	punjibhutô
পুঞ্জিভূত	punjibhutô
আকাশচুম্বী	akashcumbi
কিস করা	kis kôra
খবরদারী	khôbôrdari
খবরদারি	khôbôrdari
অন্ধ্র প্রদেশ	Ôndhrô Prôdesh
প্রাদেশিক	pradeshik
তামিল নাড়ু	Tamil Naŗu
তামিল নাড়ু	Tamil Naŗu
তামিলনাড়ু	Tamilnaŗu
বিহারী	bihari
বিহারি	bihari
উত্তরপ্রদেশ	Uttôrprôdesh
উত্তর প্রদেশ	Uttôr Prôdesh
উত্তর প্রদেশ	Uttôr Prôdesh
কেরালা	Kerala
কেরালা	Kerala
কেরল	Kerôlô
মধ্য প্রদেশ	Môddhô Prôdesh
মধ্যপ্রদেশ	Môddhôprôdesh
পশ্চিমবাংলা	Pôshcimbangla
পশ্চিম বাংলা	Pôshcim Bangla
পূর্ববাংলা	Purbôbangla
পূর্ব বাংলা	Purbô Bangla
পশ্চিম বাংলা	Pôshcim Bangla
পশ্চিম বাংলা	Pôshcim Bangla
পূর্ববাংলা	Purbôbangla
পূর্ব বাংলা	Purbô Bangla
পূর্ব বাংলা	Purbô Bangla
পূর্ব বাংলা	Purbô Bangla
পশ্চিমবাংলা	Pôshcimbangla
পশ্চিম বাংলা	Pôshcim Bangla
পশ্চিমবাংলা	Pôshcimbangla
পশ্চিমবাংলা	Pôshcimbangla
পূর্ব বাংলা	Purbô Bangla
পূর্ববাংলা	Purbôbangla
পূর্ববাংলা	Purbôbangla
পূর্ববাংলা	Purbôbangla
পশ্চিম বাংলা	Pôshcim Bangla
পশ্চিমবাংলা	Pôshcimbangla
এখন	ekhôn
কখন	kôkhôn
এরপর	erpôr
তারপর	tarpôr
এইটা	eiţa
এটা	eţa
এইটি	eiţi
এটি	eţi
ওই	oi
সেই	shei
ওইটা	oiţa
ওটা	oţa
ওইটি	oiţi
ওটি	oţi
এই	ei
সেই	shei
সেইটা	sheiţa
সেটা	sheţa
সেইটি	sheiţi
সেটি	sheţi
এই	ei
ওই	oi
মুভী	muvi
ফিল্ম	film
ভিডিও	viḑio
মুভি	muvi
ফিল্ম	film
ভিডিও	viḑio
প্লীজ	pliz
অনুগ্রহ	ônugrôhô
প্লিজ	pliz
অনুগ্রহ	ônugrôhô
চন্দ্র	côndrô
চাঁদ	cãd
অকারণে	ôkarône
আউটপুট	auţpuţ
থ্যালামাস	thêlamas
হাইপোথ্যালামাস	haipothêlamas
হাইপোথ্যালামাস	haipothêlamas
খণ্ড খণ্ড	khônḑô khônḑô
খণ্ডে খণ্ডে	khônḑe khônḑe
খণ্ড ত	khônḑô tô
খণ্ডিত	khônḑitô
ভাল	bhalô
কৃষ্ণ গহ্বর	krishnô gôhbôr
কৃষ্ণবিবর	krishnôbibôr
কৃষ্ণ বিবর	krishnô bibôr
ব্ল্যাকহোল	blêk-hol
ব্ল্যাক হোল	blêk hol
কৃষ্ণগহ্বর	krishnôgôhbôr
কৃষ্ণবিবর	krishnôbibôr
কৃষ্ণ বিবর	krishnô bibôr
ব্ল্যাকহোল	blêk-hol
ব্ল্যাক হোল	blêk hol
কৃষ্ণ বিবর	krishnô bibôr
কৃষ্ণগহ্বর	krishnôgôhbôr
কৃষ্ণ গহ্বর	krishnô gôhbôr
ব্ল্যাকহোল	blêk-hol
ব্ল্যাক হোল	blêk hol
কৃষ্ণবিবর	krishnôbibôr
কৃষ্ণগহ্বর	krishnôgôhbôr
কৃষ্ণ গহ্বর	krishnô gôhbôr
ব্ল্যাকহোল	blêk-hol
ব্ল্যাক হোল	blêk hol
ব্ল্যাক হোল	blêk hol
কৃষ্ণগহ্বর	krishnôgôhbôr
কৃষ্ণ গহ্বর	krishnô gôhbôr
কৃষ্ণবিবর	krishnôbibôr
কৃষ্ণ বিবর	krishnô bibôr
ব্ল্যাকহোল	blêk-hol
কৃষ্ণগহ্বর	krishnôgôhbôr
কৃষ্ণ গহ্বর	krishnô gôhbôr
কৃষ্ণবিবর	krishnôbibôr
কৃষ্ণ বিবর	krishnô bibôr
-এরা	-era
-টা	-ţa
-টি	-ţi
-গুলা	-gula
-গুলো	-gulo
-রা	-ra
-টা	-ţa
-টি	-ţi
-গুলা	-gula
-গুলো	-gulo
-গুলা	-gula
-টা	-ţa
-টি	-ţi
-রা	-ra
-এরা	-era
-গুলো	-gulo
-টা	-ţa
-টি	-ţi
-রা	-ra
-এরা	-era
আফগানিস্তান ইসলামী প্রজাতন্ত্র	Afganistan Islami Prôjatôntrô
আফগানিস্তান ইসলামী প্রজাতন্ত্র	Afganistan Islami Prôjatôntrô
অনিবার্য	ônibarjô
অতিরঞ্জিত	ôtirônjitô
অতিরঞ্জন	ôtirônjôn
স্নেহপ্রবণ	snehoprobôn
স্বার্থপরতা	sharthopôrta
স্বার্থপর	sharthopôr
স্বার্থপর	sharthopôr
স্বার্থপরতা	sharthopôrta
অপ্রতিষ্ঠিত	ôprôtishţhitô
প্রতিষ্ঠা	prôtishţha
প্রতিষ্ঠাতা	prôtishţhata
প্রতিষ্ঠা	prôtishţha
প্রতিষ্ঠিত	prôtishţhitô
পায়ের আঙুল	paẏer angul
হাতের আঙুল	hater angul
লিঙ্গ	linggô
শিশ্ন	shishnô
পুরুষাঙ্গ	purushanggô
পেনিস	penis
ধন	dhôn
বাড়া	baŗa
ডান্ডা	ḑanḑa
গরম	gôrôm
উষ্ণতা	ushnôta
ব্লো জব	blo jôb
ব্লো-জব	blo-jôb
গঠন করা	gôţhôn kôra
গঠিত	gôţhitô
বিদ্যুৎ	biddut
চিন্তা করা	cinta kôra
লিঙ্গ	linggô
শিশ্ন	shishnô
পুরুষাঙ্গ	purushanggô
ধন	dhôn
নুনু	nunu
বাড়া	baŗa
ডান্ডা	ḑanḑa
টি-শার্ট	ţi-sharţ
প্রকার	prôkar
নিভৃতে	nibhrite
বন্ধু	bôndhu
হাঁটু গাড়া	hãţu gaŗa
এইটা	eiţa
এটি	eţi
এইটি	eiţi
এটা	eţa
এটি	eţi
এইটি	eiţi
এটা	eţa
এইটা	eiţa
এইটি	eiţi
এটা	eţa
এইটা	eiţa
এটি	eţi
এইগুলা	eigula
এগুলো	egulo
এইগুলো	eigulo
এগুলা	egula
এগুলো	egulo
এইগুলো	eigulo
এগুলা	egula
এইগুলা	eigula
এগুলো	egulo
এগুলা	egula
এইগুলা	eigula
এইগুলো	eigulo
ওগুলা	ogula
ওইগুলা	oigula
ওগুলো	ogulo
ওগুলা	ogula
ওইগুলা	oigula
ওইগুলো	oigulo
ওইগুলা	oigula
ওগুলো	ogulo
ওইগুলো	oigulo
ওগুলা	ogula
ওগুলো	ogulo
ওইগুলো	oigulo
ওইটা	oiţa
ওটি	oţi
ওইটি	oiţi
ওটা	oţa
ওটি	oţi
ওইটি	oiţi
ওটা	oţa
ওইটা	oiţa
ওটি	oţi
ওটা	oţa
ওইটা	oiţa
ওইটি	oiţi
সেইটা	sheiţa
সেটি	sheţi
সেইটি	sheiţi
সেটা	sheţa
সেটি	sheţi
সেইটি	sheiţi
সেটা	sheţa
সেইটা	sheiţa
সেটি	sheţi
সেটা	sheţa
সেইটা	sheiţa
সেইটি	sheiţi
সেইগুলা	sheigula
সেগুলো	shegulo
সেইগুলো	sheigulo
সেগুলা	shegula
সেগুলো	shegulo
সেইগুলো	sheigulo
সেগুলা	shegula
সেইগুলা	sheigula
সেইগুলো	sheigulo
সেগুলা	shegula
সেইগুলা	sheigula
সেগুলো	shegulo
কৃত্রিম বুদ্ধিমত্তা	kritrim buddhimôtta
কৃত্রিমতা	kritrimta
প্রজাতন্ত্রী লিথুয়ানিয়া	prajātantrī lithuẏāniẏā
প্রজাতন্ত্রী লাতভিয়া	prajātantrī lātabhiẏā
ধোঁয়া	dhõẇa
ইবলিশ	iblis
সাবধান	sābdhān
ঘুম	ghuma
দক্ষিণ সুদান	dôkhin sudan
ডন কিহোতে	ŗôn kihete
ইরানী	Irani
ইরানি	Irani
এলিস দ্বীপপুঞ্জ	Ellice Islands
ধর্ম	dhôrmô
ওড়িশা	ōṛiśā
টাকা	ṭaka
সাইদ	Said
নাস্তালিক	nastalik
ফোন	phon
আপনার সাহায্য লাগবে?	apnar shahajjo lagbe?
তোমার সাহায্য লাগবে?	tomar shahajjo lagbe?
আমার প্রশ্ন আছে	amar prôshno ache
আরোগ্য	ārōgya
মুভি	muvi
ভিডিও	viḑio
বৃষ্টি পড়ছে	brishţi pôŗche
ভারতীয় প্রজাতন্ত্র	bhārôtiyô prôjatôntrô
তামাক	tamak
লুট	lūṭ
লুটা	luṭā
লুটেরা	luṭērā
বেল	bēla
ম্যান্ডেলা	mænḑela
খুলনা	khulna
শূন্য	śūnya
ফুল	phul
অঙ্গুষ্ঠ	aṅguṣṭh
সতর্ক	sôtôrkô
সরকার	sarkār
শূন্য	shunno
নব্য নাৎসীবাদ	nôbyô natsibad
রাম	ram
কুকুর	kukur
নান	nan
মটোরোলা	môţorola
অক্ষত	akṣata
পশ্চিম ইউরোপীয় সজারু	paścima i'urōpīẏa sajāru
জল	jal
পানি	pāni
রাজশাহী	rajshahi
আট	aṭ
আগুন	āgun
মরা	môra
শুওর	shuor
আমার ... লাগবে	amar ... lagbe
নখ	nôkh
তিথি	tithi
পাদা	pādā
বাজার	bājār
গাজর	gājara
পনির	panir
চন্দন	côndôn
হাঁস	hãs
বাংলা নববর্ষ	Bangla Nôbobôrsho
নাখুদা	nākhudā
নাখোদা	nākhōdā
নাসরিন	Nasrīn
নাসরীন	Nasrin
পাঞ্জাব	Panjab
আঙুল	angul
হাতের আঙুল	hater angul
পায়ের আঙুল	paẏer angul
চার	car
আসসালামু আলাইকুম	as-salamu alaikum
মজলিস	môjlis
জানালা	janala
জিহ্বা	jihba
আপনি ঈশ্বর আমাকে দেওয়া হয়েছে যে সেরা উপহার ।	apni ishbôr amake de'oẏa haẏeche ye sere uphar.
কাগজ	kagôj
জাফরাবাদী	japhôrabadī
গির্জা	girja
সাবাশ	
শত	śata
রংপুর	Rôngpur
তিন	tin
পালং	pālaṁ
