f	f
v	v
s	s
z	z
S	ʃ
Z	ʒ
x	x
h\	ɦ
p	p
b	b
t	t
d	d
k	k
g	ɡ
m	m
n	n
N	ŋ
i	i
y	y
u	u
2:	øː
E	ɛ
O	ɔ
a	a
A:	ɑː
@	ə
{	æ
9	œ
@i	əi̯
9y	œy̯
@u	əu̯
i@	iə̯
u@	uə̯
r	r
l	l
j	j
w	w
